AAAAAACCTAT -> AAAAACCTATC
AAAAACCTATC -> AAAACCTATCC
AAAAAGCTGTG -> AAAAGCTGTGC
AAAACCTATCC -> AAACCTATCCA
AAAACGCCCAT -> AAACGCCCATT
AAAAGCAATAG -> AAAGCAATAGT
AAAAGCTGTGC -> AAAGCTGTGCT
AAAATACATCA -> AAATACATCAA
AAACAGAAGGG -> AACAGAAGGGT
AAACAGGTGCC -> AACAGGTGCCG
AAACATATTAG -> AACATATTAGA
AAACCTATCCA -> AACCTATCCAC
AAACGCCCATT -> AACGCCCATTA
AAAGAAGAAGT -> AAGAAGAAGTC
AAAGAGGATCC -> AAGAGGATCCA
AAAGCAATAGT -> AAGCAATAGTA
AAAGCTGTGCT -> AAGCTGTGCTA
AAAGGACACTG -> AAGGACACTGA
AAAGGCATGTA -> AAGGCATGTAT
AAAGTATGTGA -> AAGTATGTGAG
AAAGTCCCTTC -> AAGTCCCTTCC
AAAGTGATACA -> AAGTGATACAA
AAAGTTCGTTG -> AAGTTCGTTGG
AAATAAACAGA -> AATAAACAGAA
AAATACATCAA -> AATACATCAAG
AAATACCTTCA -> AATACCTTCAA
AAATATTGGCG -> AATATTGGCGC
AAATGACGAAG -> AATGACGAAGC
AAATTCCCTAC -> AATTCCCTACC
AACAAAGGACA -> ACAAAGGACAC
AACAAGCGAGG -> ACAAGCGAGGA
AACACCGCACC -> ACACCGCACCT
AACACGAGGAG -> ACACGAGGAGT
AACAGAAGGGT -> ACAGAAGGGTG
AACAGACCCTT -> ACAGACCCTTT
AACAGCGCACG -> ACAGCGCACGA
AACAGGTGCCG -> ACAGGTGCCGC
AACATACAGTG -> ACATACAGTGG
AACATATTAGA -> ACATATTAGAT
AACATGATTGG -> ACATGATTGGT
AACATGCAGAA -> ACATGCAGAAC
AACCACCTGTA -> ACCACCTGTAC
AACCACGGCCA -> ACCACGGCCAC
AACCATGCGGT -> ACCATGCGGTG
AACCCTTACTC -> ACCCTTACTCT
AACCTATCCAC -> ACCTATCCACA
AACCTATCTTC -> ACCTATCTTCC
AACCTCTTCGA -> ACCTCTTCGAC
AACGACTATGA -> ACGACTATGAA
AACGAGCTGCA -> ACGAGCTGCAT
AACGCCCATTA -> ACGCCCATTAA
AACGCCTCATT -> ACGCCTCATTC
AACGGCATAGC -> ACGGCATAGCT
AACGTGAAGAC -> ACGTGAAGACC
AACGTTTGTCT -> ACGTTTGTCTG
AACTAAGATAA -> ACTAAGATAAA
AACTCAAAAGC -> ACTCAAAAGCA
AACTGAGGTGG -> ACTGAGGTGGG
AACTGGCATCA -> ACTGGCATCAA
AACTTGTGCGC -> ACTTGTGCGCC
AACTTTTGCTC -> ACTTTTGCTCT
AAGAAGAAGTC -> AGAAGAAGTCA
AAGAAGTCAGT -> AGAAGTCAGTG
AAGACAATTCC -> AGACAATTCCT
AAGACCCATCA -> AGACCCATCAG
AAGACCGATAC -> AGACCGATACT
AAGAGCTCTTA -> AGAGCTCTTAC
AAGAGGATCCA -> AGAGGATCCAG
AAGATAAATTC -> AGATAAATTCC
AAGATCATGTT -> AGATCATGTTT
AAGATTAAAGT -> AGATTAAAGTT
AAGCAATAGTA -> AGCAATAGTAT
AAGCACTGTGC -> AGCACTGTGCA
AAGCCAGCAAA -> AGCCAGCAAAG
AAGCCCAAGGG -> AGCCCAAGGGG
AAGCGAGGACA -> AGCGAGGACAT
AAGCGCGTCAG -> AGCGCGTCAGG
AAGCGGTTATA -> AGCGGTTATAA
AAGCTGTGCTA -> AGCTGTGCTAG
AAGGACACTGA -> AGGACACTGAG
AAGGCAATCGC -> AGGCAATCGCG
AAGGCATGTAT -> AGGCATGTATG
AAGGCGACATG -> AGGCGACATGT
AAGGGGTTCTA -> AGGGGTTCTAT
AAGGGTGTGGT -> AGGGTGTGGTG
AAGTAGGTCAA -> AGTAGGTCAAC
AAGTATGTGAG -> AGTATGTGAGA
AAGTCAGTGCA -> AGTCAGTGCAT
AAGTCCCTTCC -> AGTCCCTTCCC
AAGTGATACAA -> AGTGATACAAA
AAGTGGCCATG -> AGTGGCCATGG
AAGTGGGGGCC -> AGTGGGGGCCT
AAGTTCGTTGG -> AGTTCGTTGGA
AATAAACAGAA -> ATAAACAGAAG
AATAAGTGGCC -> ATAAGTGGCCA
AATACATCAAG -> ATACATCAAGA
AATACCTTCAA -> ATACCTTCAAT
AATACTCAATA -> ATACTCAATAG
AATACTTCAAC -> ATACTTCAACG
AATAGCGAGGT -> ATAGCGAGGTC
AATAGTACAGC -> ATAGTACAGCT
AATAGTATCGC -> ATAGTATCGCG
AATATGCGGCG -> ATATGCGGCGC
AATATGTATAG -> ATATGTATAGT
AATATTGGCGC -> ATATTGGCGCC
AATCGACCAGG -> ATCGACCAGGT
AATCGCGCGGA -> ATCGCGCGGAG
AATCTGTTTTC -> ATCTGTTTTCG
AATGAACCATG -> ATGAACCATGC
AATGACGAAGC -> ATGACGAAGCC
AATGACGGAGG -> ATGACGGAGGT
AATGATGGGTA -> ATGATGGGTAG
AATGCTACTGA -> ATGCTACTGAC
AATGGGCAGCG -> ATGGGCAGCGT
AATGTGTTGCA -> ATGTGTTGCAT
AATGTTAGTAC -> ATGTTAGTACG
AATTATCGGTG -> ATTATCGGTGA
AATTATGATTC -> ATTATGATTCT
AATTATTTAAA -> ATTATTTAAAG
AATTCCCCTAT -> ATTCCCCTATC
AATTCCCTACC -> ATTCCCTACCA
AATTCCTCGAT -> ATTCCTCGATA
AATTGATAACT -> ATTGATAACTT
AATTGGTGTTG -> ATTGGTGTTGA
AATTTCGGAAG -> ATTTCGGAAGG
AATTTGACCTG -> ATTTGACCTGC
ACAAAACGCCC -> CAAAACGCCCA
ACAAAGGACAC -> CAAAGGACACT
ACAAAGTCCCT -> CAAAGTCCCTT
ACAACCTCTTC -> CAACCTCTTCG
ACAAGCGAGGA -> CAAGCGAGGAC
ACAAGTAGGTC -> CAAGTAGGTCA
ACAATCGACCA -> CAATCGACCAG
ACAATTCCTCG -> CAATTCCTCGA
ACACATGCTAA -> CACATGCTAAA
ACACATTGGTA -> CACATTGGTAG
ACACCCACTCC -> CACCCACTCCC
ACACCGCACCT -> CACCGCACCTG
ACACGAGGAGT -> CACGAGGAGTG
ACACGGGATTA -> CACGGGATTAG
ACACTGAGTTG -> CACTGAGTTGA
ACAGAAATATT -> CAGAAATATTG
ACAGAAGGGTG -> CAGAAGGGTGT
ACAGACCCTTT -> CAGACCCTTTG
ACAGATTGGCC -> CAGATTGGCCC
ACAGCGCACGA -> CAGCGCACGAT
ACAGCTTCAAA -> CAGCTTCAAAT
ACAGGGCCTTG -> CAGGGCCTTGA
ACAGGGTTCCT -> CAGGGTTCCTT
ACAGGTGCCGC -> CAGGTGCCGCG
ACAGTGGGAGG -> CAGTGGGAGGA
ACAGTTCTGCT -> CAGTTCTGCTA
ACATACAGTGG -> CATACAGTGGG
ACATATTAGAT -> CATATTAGATG
ACATCAAGATT -> CATCAAGATTA
ACATGATTGGT -> CATGATTGGTT
ACATGCAGAAC -> CATGCAGAACT
ACATGCTAAAA -> CATGCTAAAAA
ACATGTACCGT -> CATGTACCGTA
ACATTCGGCTT -> CATTCGGCTTT
ACATTGGTAGA -> CATTGGTAGAA
ACATTGTGAAT -> CATTGTGAATA
ACATTTATCCA -> CATTTATCCAA
ACCACCTGTAC -> CCACCTGTACA
ACCACGGCCAC -> CCACGGCCACA
ACCAGCCCGTG -> CCAGCCCGTGA
ACCAGGCTTCT -> CCAGGCTTCTG
ACCAGGTAAGC -> CCAGGTAAGCG
ACCATGCGGTG -> CCATGCGGTGT
ACCATTACCTA -> CCATTACCTAG
ACCCACTCCCG -> CCCACTCCCGT
ACCCATCAGCA -> CCCATCAGCAA
ACCCTAGGGAA -> CCCTAGGGAAT
ACCCTTACTCT -> CCCTTACTCTC
ACCCTTCCATT -> CCCTTCCATTG
ACCCTTTGGGA -> CCCTTTGGGAG
ACCGAACGGCA -> CCGAACGGCAT
ACCGATACTTT -> CCGATACTTTG
ACCGCACCTGT -> CCGCACCTGTT
ACCGTATACTC -> CCGTATACTCT
ACCTAGCTAGC -> CCTAGCTAGCC
ACCTATCCACA -> CCTATCCACAT
ACCTATCTTCC -> CCTATCTTCCT
ACCTCTTCGAC -> CCTCTTCGACA
ACCTGCGGTCA -> CCTGCGGTCAT
ACCTGGAAGCA -> CCTGGAAGCAC
ACCTGTACAAG -> CCTGTACAAGT
ACCTGTTCCTA -> CCTGTTCCTAT
ACCTTCAATAC -> CCTTCAATACT
ACCTTTAGAGG -> CCTTTAGAGGC
ACGAACGTTTG -> CGAACGTTTGT
ACGAAGCCCAA -> CGAAGCCCAAG
ACGACCAGGCT -> CGACCAGGCTT
ACGACTATGAA -> CGACTATGAAG
ACGAGCTGCAT -> CGAGCTGCATA
ACGAGGAGTGT -> CGAGGAGTGTT
ACGAGGATAGG -> CGAGGATAGGG
ACGATGGATTT -> CGATGGATTTC
ACGCAAAGGCA -> CGCAAAGGCAT
ACGCCCATTAA -> CGCCCATTAAC
ACGCCTCATTC -> CGCCTCATTCA
ACGCCTGCATT -> CGCCTGCATTA
ACGGAGGTATT -> CGGAGGTATTT
ACGGCATAGCT -> CGGCATAGCTC
ACGGCCACAAC -> CGGCCACAACC
ACGGGATTAGC -> CGGGATTAGCA
ACGTAACGTGA -> CGTAACGTGAA
ACGTGAAGACC -> CGTGAAGACCC
ACGTTAACAAA -> CGTTAACAAAG
ACGTTATTTCG -> CGTTATTTCGA
ACGTTTGTCTG -> CGTTTGTCTGG
ACTAAGATAAA -> CTAAGATAAAT
ACTATGAAGAC -> CTATGAAGACA
ACTCAAAAGCA -> CTCAAAAGCAA
ACTCAATAGCG -> CTCAATAGCGA
ACTCCCGTAGT -> CTCCCGTAGTG
ACTCTCATCAG -> CTCTCATCAGA
ACTCTCGATTC -> CTCTCGATTCG
ACTGACAGGGC -> CTGACAGGGCC
ACTGAGAGCGC -> CTGAGAGCGCC
ACTGAGGTGGG -> CTGAGGTGGGA
ACTGAGTTGAG -> CTGAGTTGAGC
ACTGCTTGGGT -> CTGCTTGGGTA
ACTGGCATCAA -> CTGGCATCAAG
ACTGGTGGGAA -> CTGGTGGGAAC
ACTGTGCAAAC -> CTGTGCAAACA
ACTTAGTGGAC -> CTTAGTGGACT
ACTTATTCTCG -> CTTATTCTCGT
ACTTCAACGCC -> CTTCAACGCCT
ACTTGTGCGCC -> CTTGTGCGCCA
ACTTTGTTTTA -> CTTTGTTTTAT
ACTTTTGCTCT -> CTTTTGCTCTC
ACTTTTTGCCG -> CTTTTTGCCGC
AGAAATATTGG -> GAAATATTGGC
AGAACACGAGG -> GAACACGAGGA
AGAACCCTTAC -> GAACCCTTACT
AGAACTAAGAT -> GAACTAAGATA
AGAAGAAGTCA -> GAAGAAGTCAG
AGAAGGGTGTG -> GAAGGGTGTGG
AGAAGTCAGTG -> GAAGTCAGTGC
AGACAATTCCT -> GACAATTCCTC
AGACCAGCCCG -> GACCAGCCCGT
AGACCCATCAG -> GACCCATCAGC
AGACCCTAGGG -> GACCCTAGGGA
AGACCCTTTGG -> GACCCTTTGGG
AGACCGATACT -> GACCGATACTT
AGACTGAGAGC -> GACTGAGAGCG
AGAGACCAGCC -> GAGACCAGCCC
AGAGCGATGCT -> GAGCGATGCTA
AGAGCGCCAGT -> GAGCGCCAGTT
AGAGCTCTTAC -> GAGCTCTTACT
AGAGGATCCAG -> GAGGATCCAGG
AGAGGCACGTA -> GAGGCACGTAA
AGAGGCTGCGG -> GAGGCTGCGGT
AGATAAATTCC -> GATAAATTCCC
AGATATTGTAT -> GATATTGTATA
AGATCATGTTT -> GATCATGTTTA
AGATCCAATGT -> GATCCAATGTT
AGATGGGATCG -> GATGGGATCGA
AGATTAAAGTT -> GATTAAAGTTC
AGATTGATGAG -> GATTGATGAGA
AGATTGGCCCT -> GATTGGCCCTA
AGCAAAGAGGA -> GCAAAGAGGAT
AGCAACGAGCT -> GCAACGAGCTG
AGCAACTTGTG -> GCAACTTGTGC
AGCAATAGTAT -> GCAATAGTATC
AGCACAAAACG -> GCACAAAACGC
AGCACCTTTAG -> GCACCTTTAGA
AGCACTGTGCA -> GCACTGTGCAA
AGCATGAATAA -> GCATGAATAAG
AGCATTTTTAT -> GCATTTTTATA
AGCATTTTTTA -> GCATTTTTTAA
AGCCAATGAAC -> GCCAATGAACC
AGCCAGCAAAG -> GCCAGCAAAGA
AGCCCAAGGGG -> GCCCAAGGGGT
AGCCCCTGAAA -> GCCCCTGAAAT
AGCCCGTGATC -> GCCCGTGATCG
AGCGAGGACAT -> GCGAGGACATT
AGCGAGGTCAT -> GCGAGGTCATT
AGCGATGCTAA -> GCGATGCTAAG
AGCGCACGATG -> GCGCACGATGG
AGCGCAGCGCC -> GCGCAGCGCCA
AGCGCCAACAC -> GCGCCAACACC
AGCGCCAGTTG -> GCGCCAGTTGC
AGCGCGTCAGG -> GCGCGTCAGGA
AGCGCTCTTCC -> GCGCTCTTCCG
AGCGGTAAGCC -> GCGGTAAGCCA
AGCGGTTATAA -> GCGGTTATAAC
AGCGTCAAGGC -> GCGTCAAGGCG
AGCGTGGCCTC -> GCGTGGCCTCG
AGCTAGCAACG -> GCTAGCAACGA
AGCTAGCCCCT -> GCTAGCCCCTG
AGCTCTATACT -> GCTCTATACTG
AGCTCTTACTT -> GCTCTTACTTT
AGCTGCATACG -> GCTGCATACGT
AGCTGGACTTA -> GCTGGACTTAG
AGCTGTAGGAC -> GCTGTAGGACA
AGCTGTGCTAG -> GCTGTGCTAGC
AGCTTCAAATA -> GCTTCAAATAC
AGCTTCTTTTA -> GCTTCTTTTAG
AGGAACGACTA -> GGAACGACTAT
AGGAATATGTA -> GGAATATGTAT
AGGACACCCAC -> GGACACCCACT
AGGACACTGAG -> GGACACTGAGT
AGGACATTCGG -> GGACATTCGGC
AGGACGCAAAG -> GGACGCAAAGG
AGGAGCTAGCA -> GGAGCTAGCAA
AGGAGGCCGAA -> GGAGGCCGAAT
AGGAGTGTTTA -> GGAGTGTTTAG
AGGATAGGGCC -> GGATAGGGCCC
AGGATCCAGGC -> GGATCCAGGCC
AGGCAATCGCG -> GGCAATCGCGC
AGGCACGTAAC -> GGCACGTAACG
AGGCATGTATG -> GGCATGTATGA
AGGCCGAATTA -> GGCCGAATTAT
AGGCCGCGGCA -> GGCCGCGGCAT
AGGCGACATGT -> GGCGACATGTA
AGGCGCCTAGC -> GGCGCCTAGCA
AGGCTGCGGTG -> GGCTGCGGTGT
AGGCTTCTGCA -> GGCTTCTGCAG
AGGGAATATGC -> GGGAATATGCG
AGGGACGAACG -> GGGACGAACGT
AGGGACGACCA -> GGGACGACCAG
AGGGACTTATT -> GGGACTTATTC
AGGGCCCTCGC -> GGGCCCTCGCC
AGGGCCTTGAA -> GGGCCTTGAAT
AGGGGTCGGCA -> GGGGTCGGCAA
AGGGGTTCTAT -> GGGGTTCTATA
AGGGTGTGGTG -> GGGTGTGGTGT
AGGGTTCCTTA -> GGGTTCCTTAT
AGGTAAGCGCG -> GGTAAGCGCGT
AGGTATTTATG -> GGTATTTATGG
AGGTCAACAGC -> GGTCAACAGCG
AGGTCATTGGT -> GGTCATTGGTC
AGGTGCCGCGG -> GGTGCCGCGGC
AGGTGGGAATG -> GGTGGGAATGA
AGGTTATGTGT -> GGTTATGTGTA
AGTAACCACGG -> GTAACCACGGC
AGTAAGACCGA -> GTAAGACCGAT
AGTAATGGGCA -> GTAATGGGCAG
AGTACAGCTTC -> GTACAGCTTCA
AGTACAGGGTT -> GTACAGGGTTC
AGTACGAGGAT -> GTACGAGGATA
AGTAGGTCAAC -> GTAGGTCAACA
AGTATCGCGGA -> GTATCGCGGAC
AGTATGTGAGA -> GTATGTGAGAC
AGTATTTTGTC -> GTATTTTGTCT
AGTCACAGATT -> GTCACAGATTG
AGTCAGTGCAT -> GTCAGTGCATG
AGTCCCGAGTA -> GTCCCGAGTAA
AGTCCCTTCCC -> GTCCCTTCCCG
AGTCCGCATAG -> GTCCGCATAGT
AGTCGAAAATA -> GTCGAAAATAC
AGTCTGATCGC -> GTCTGATCGCA
AGTGAGCTGTA -> GTGAGCTGTAG
AGTGATACAAA -> GTGATACAAAG
AGTGATGCAAA -> GTGATGCAAAT
AGTGCATGCAT -> GTGCATGCATG
AGTGGACTGGT -> GTGGACTGGTG
AGTGGCCATGG -> GTGGCCATGGA
AGTGGCGGGTC -> GTGGCGGGTCT
AGTGGGAGGAA -> GTGGGAGGAAT
AGTGGGGGCCT -> GTGGGGGCCTT
AGTGTTTAGTG -> GTGTTTAGTGA
AGTTATCAATC -> GTTATCAATCT
AGTTCGTTGGA -> GTTCGTTGGAA
AGTTCTGCTAG -> GTTCTGCTAGC
AGTTGAGCGTC -> GTTGAGCGTCA
AGTTGCAGGCG -> GTTGCAGGCGC
ATAAACAGAAG -> TAAACAGAAGG
ATAAACAGGTG -> TAAACAGGTGC
ATAAATTCCCT -> TAAATTCCCTA
ATAACATACAG -> TAACATACAGT
ATAACTTTTGC -> TAACTTTTGCT
ATAAGTGGCCA -> TAAGTGGCCAT
ATACAAAGTCC -> TACAAAGTCCC
ATACAGTGGGA -> TACAGTGGGAG
ATACATCAAGA -> TACATCAAGAT
ATACCTTCAAT -> TACCTTCAATA
ATACGTTAACA -> TACGTTAACAA
ATACGTTATTT -> TACGTTATTTC
ATACTCAATAG -> TACTCAATAGC
ATACTCTCATC -> TACTCTCATCA
ATACTGCTTGG -> TACTGCTTGGG
ATACTTCAACG -> TACTTCAACGC
ATACTTTGTTT -> TACTTTGTTTT
ATAGCGAGGTC -> TAGCGAGGTCA
ATAGCGCTCTT -> TAGCGCTCTTC
ATAGCTCTATA -> TAGCTCTATAC
ATAGGGCCCTC -> TAGGGCCCTCG
ATAGTAAGACC -> TAGTAAGACCG
ATAGTACAGCT -> TAGTACAGCTT
ATAGTATCGCG -> TAGTATCGCGG
ATAGTTATCAA -> TAGTTATCAAT
ATATCCTTAGA -> TATCCTTAGAA
ATATCTAGAGA -> TATCTAGAGAC
ATATGCGGCGC -> TATGCGGCGCT
ATATGTATAGT -> TATGTATAGTT
ATATTAGATGG -> TATTAGATGGG
ATATTCAATTA -> TATTCAATTAT
ATATTCCGTAT -> TATTCCGTATT
ATATTGGCGCC -> TATTGGCGCCA
ATATTGTATAT -> TATTGTATATC
ATCAAGAGCTC -> TCAAGAGCTCT
ATCAAGATTAA -> TCAAGATTAAA
ATCAATCTGTT -> TCAATCTGTTT
ATCAGATCCAA -> TCAGATCCAAT
ATCAGCAACTT -> TCAGCAACTTG
ATCAGTCCGCA -> TCAGTCCGCAT
ATCATGTTTAG -> TCATGTTTAGA
ATCATTCGACA -> TCATTCGACAC
ATCCAACCTAT -> TCCAACCTATC
ATCCAATGTTA -> TCCAATGTTAG
ATCCACATTGT -> TCCACATTGTG
ATCCAGGCCGC -> TCCAGGCCGCG
ATCCTCATAGC -> TCCTCATAGCG
ATCCTTAGAAC -> TCCTTAGAACC
ATCGACCAGGT -> TCGACCAGGTA
ATCGAGCGCAG -> TCGAGCGCAGC
ATCGCAGGAAC -> TCGCAGGAACG
ATCGCGCGGAG -> TCGCGCGGAGT
ATCGCGGACAG -> TCGCGGACAGT
ATCGGAACAGA -> TCGGAACAGAC
ATCGGTGAGGG -> TCGGTGAGGGA
ATCGTCCTAGC -> TCGTCCTAGCA
ATCTAGAGACC -> TCTAGAGACCA
ATCTAGGGACG -> TCTAGGGACGA
ATCTAGTCTGA -> TCTAGTCTGAT
ATCTGTTTTCG -> TCTGTTTTCGA
ATCTTCCTGCG -> TCTTCCTGCGG
ATCTTTGTGGT -> TCTTTGTGGTT
ATGAACCATGC -> TGAACCATGCG
ATGAACTCAAA -> TGAACTCAAAA
ATGAAGACAAT -> TGAAGACAATT
ATGAATAAGTG -> TGAATAAGTGG
ATGAATACTCA -> TGAATACTCAA
ATGAATTCCCC -> TGAATTCCCCT
ATGACGAAGCC -> TGACGAAGCCC
ATGACGGAGGT -> TGACGGAGGTA
ATGAGATATTG -> TGAGATATTGT
ATGATGGGTAG -> TGATGGGTAGC
ATGATTCTTGG -> TGATTCTTGGG
ATGATTGGTTA -> TGATTGGTTAT
ATGCAAATGAC -> TGCAAATGACG
ATGCAGAACTA -> TGCAGAACTAA
ATGCATGCCGA -> TGCATGCCGAT
ATGCCGATGGA -> TGCCGATGGAA
ATGCGGCGCTG -> TGCGGCGCTGC
ATGCGGTGTCG -> TGCGGTGTCGT
ATGCTAAAAAG -> TGCTAAAAAGC
ATGCTAAGATC -> TGCTAAGATCA
ATGCTACTGAC -> TGCTACTGACA
ATGGAATTGAT -> TGGAATTGATA
ATGGACACGGG -> TGGACACGGGA
ATGGATCATTC -> TGGATCATTCG
ATGGATTTCCT -> TGGATTTCCTG
ATGGGATCGAG -> TGGGATCGAGC
ATGGGCAGCGT -> TGGGCAGCGTG
ATGGGTAGCTT -> TGGGTAGCTTC
ATGGTGTAATG -> TGGTGTAATGC
ATGTACCGTAT -> TGTACCGTATA
ATGTACCTGGA -> TGTACCTGGAA
ATGTATAGTTA -> TGTATAGTTAT
ATGTATGAATA -> TGTATGAATAC
ATGTCAAAGTA -> TGTCAAAGTAT
ATGTGAGACCC -> TGTGAGACCCT
ATGTGTAACAT -> TGTGTAACATG
ATGTGTTGCAT -> TGTGTTGCATG
ATGTTAGTACG -> TGTTAGTACGA
ATGTTTAGACT -> TGTTTAGACTG
ATTAAAGTTCG -> TTAAAGTTCGT
ATTAACAAGCG -> TTAACAAGCGA
ATTACCTAGCT -> TTACCTAGCTA
ATTAGATGGGA -> TTAGATGGGAT
ATTAGCACCTT -> TTAGCACCTTT
ATTAGTCACAG -> TTAGTCACAGA
ATTATCGGTGA -> TTATCGGTGAG
ATTATGATTCT -> TTATGATTCTT
ATTATTTAAAG -> TTATTTAAAGA
ATTCAATTATC -> TTCAATTATCG
ATTCACAGAAA -> TTCACAGAAAT
ATTCACGCCTG -> TTCACGCCTGC
ATTCCCCTATC -> TTCCCCTATCA
ATTCCCTACCA -> TTCCCTACCAT
ATTCCGTATTC -> TTCCGTATTCT
ATTCCTCGATA -> TTCCTCGATAA
ATTCGACACAT -> TTCGACACATT
ATTCGGCTTTT -> TTCGGCTTTTC
ATTCGTGTGGT -> TTCGTGTGGTG
ATTCTAATTTC -> TTCTAATTTCG
ATTCTCGTAGA -> TTCTCGTAGAG
ATTCTTGGGGC -> TTCTTGGGGCC
ATTGATAACTT -> TTGATAACTTT
ATTGATCTTTG -> TTGATCTTTGT
ATTGATGAGAT -> TTGATGAGATA
ATTGGCCCTAA -> TTGGCCCTAAG
ATTGGCGCCAG -> TTGGCGCCAGG
ATTGGTAGAAC -> TTGGTAGAACA
ATTGGTCGGGA -> TTGGTCGGGAG
ATTGGTGTTGA -> TTGGTGTTGAG
ATTGGTTATAC -> TTGGTTATACG
ATTGTATATCC -> TTGTATATCCT
ATTGTGAATAG -> TTGTGAATAGT
ATTTAAAGAAG -> TTTAAAGAAGA
ATTTATCCAAC -> TTTATCCAACC
ATTTATGGTGT -> TTTATGGTGTA
ATTTCCTGTCA -> TTTCCTGTCAA
ATTTCGATCTA -> TTTCGATCTAG
ATTTCGGAAGG -> TTTCGGAAGGC
ATTTGACCTGC -> TTTGACCTGCG
ATTTTGTCTTA -> TTTTGTCTTAA
ATTTTTATATT -> TTTTTATATTC
ATTTTTTAACC -> TTTTTTAACCA
CAAAACGCCCA -> AAAACGCCCAT
CAAAAGCAATA -> AAAAGCAATAG
CAAACATATTA -> AAACATATTAG
CAAAGAGGATC -> AAAGAGGATCC
CAAAGGACACT -> AAAGGACACTG
CAAAGGCATGT -> AAAGGCATGTA
CAAAGTATGTG -> AAAGTATGTGA
CAAAGTCCCTT -> AAAGTCCCTTC
CAAATACCTTC -> AAATACCTTCA
CAAATGACGAA -> AAATGACGAAG
CAACACCGCAC -> AACACCGCACC
CAACAGCGCAC -> AACAGCGCACG
CAACCTATCTT -> AACCTATCTTC
CAACCTCTTCG -> AACCTCTTCGA
CAACGAGCTGC -> AACGAGCTGCA
CAACGCCTCAT -> AACGCCTCATT
CAACTTGTGCG -> AACTTGTGCGC
CAAGAGCTCTT -> AAGAGCTCTTA
CAAGATTAAAG -> AAGATTAAAGT
CAAGCGAGGAC -> AAGCGAGGACA
CAAGGCGACAT -> AAGGCGACATG
CAAGGGGTTCT -> AAGGGGTTCTA
CAAGTAGGTCA -> AAGTAGGTCAA
CAAGTGGGGGC -> AAGTGGGGGCC
CAATACTTCAA -> AATACTTCAAC
CAATAGCGAGG -> AATAGCGAGGT
CAATAGTATCG -> AATAGTATCGC
CAATCGACCAG -> AATCGACCAGG
CAATCGCGCGG -> AATCGCGCGGA
CAATCTGTTTT -> AATCTGTTTTC
CAATGAACCAT -> AATGAACCATG
CAATGACGGAG -> AATGACGGAGG
CAATGTTAGTA -> AATGTTAGTAC
CAATTATCGGT -> AATTATCGGTG
CAATTCCTCGA -> AATTCCTCGAT
CAATTGGTGTT -> AATTGGTGTTG
CACAAAACGCC -> ACAAAACGCCC
CACAACCTCTT -> ACAACCTCTTC
CACAATCGACC -> ACAATCGACCA
CACAGAAATAT -> ACAGAAATATT
CACAGATTGGC -> ACAGATTGGCC
CACATGCTAAA -> ACATGCTAAAA
CACATTGGTAG -> ACATTGGTAGA
CACATTGTGAA -> ACATTGTGAAT
CACATTTATCC -> ACATTTATCCA
CACCCACTCCC -> ACCCACTCCCG
CACCGCACCTG -> ACCGCACCTGT
CACCTGTACAA -> ACCTGTACAAG
CACCTGTTCCT -> ACCTGTTCCTA
CACCTTTAGAG -> ACCTTTAGAGG
CACGAGGAGTG -> ACGAGGAGTGT
CACGATGGATT -> ACGATGGATTT
CACGCCTGCAT -> ACGCCTGCATT
CACGGCCACAA -> ACGGCCACAAC
CACGGGATTAG -> ACGGGATTAGC
CACGTAACGTG -> ACGTAACGTGA
CACTCCCGTAG -> ACTCCCGTAGT
CACTGAGTTGA -> ACTGAGTTGAG
CACTGTGCAAA -> ACTGTGCAAAC
CAGAAATATTG -> AGAAATATTGG
CAGAACTAAGA -> AGAACTAAGAT
CAGAAGGGTGT -> AGAAGGGTGTG
CAGACCCTTTG -> AGACCCTTTGG
CAGATCCAATG -> AGATCCAATGT
CAGATTGATGA -> AGATTGATGAG
CAGATTGGCCC -> AGATTGGCCCT
CAGCAAAGAGG -> AGCAAAGAGGA
CAGCAACTTGT -> AGCAACTTGTG
CAGCCCGTGAT -> AGCCCGTGATC
CAGCGCACGAT -> AGCGCACGATG
CAGCGCCAACA -> AGCGCCAACAC
CAGCGTGGCCT -> AGCGTGGCCTC
CAGCTTCAAAT -> AGCTTCAAATA
CAGGAACGACT -> AGGAACGACTA
CAGGAGCTAGC -> AGGAGCTAGCA
CAGGCCGCGGC -> AGGCCGCGGCA
CAGGCGCCTAG -> AGGCGCCTAGC
CAGGCTTCTGC -> AGGCTTCTGCA
CAGGGACGACC -> AGGGACGACCA
CAGGGCCTTGA -> AGGGCCTTGAA
CAGGGTTCCTT -> AGGGTTCCTTA
CAGGTAAGCGC -> AGGTAAGCGCG
CAGGTGCCGCG -> AGGTGCCGCGG
CAGTAACCACG -> AGTAACCACGG
CAGTCCGCATA -> AGTCCGCATAG
CAGTGCATGCA -> AGTGCATGCAT
CAGTGGGAGGA -> AGTGGGAGGAA
CAGTTCTGCTA -> AGTTCTGCTAG
CAGTTGCAGGC -> AGTTGCAGGCG
CATACAGTGGG -> ATACAGTGGGA
CATACGTTATT -> ATACGTTATTT
CATAGCGCTCT -> ATAGCGCTCTT
CATAGCTCTAT -> ATAGCTCTATA
CATAGTAAGAC -> ATAGTAAGACC
CATATTAGATG -> ATATTAGATGG
CATCAAGAGCT -> ATCAAGAGCTC
CATCAAGATTA -> ATCAAGATTAA
CATCAGATCCA -> ATCAGATCCAA
CATCAGCAACT -> ATCAGCAACTT
CATCCTCATAG -> ATCCTCATAGC
CATCTAGGGAC -> ATCTAGGGACG
CATGAATAAGT -> ATGAATAAGTG
CATGATTGGTT -> ATGATTGGTTA
CATGCAGAACT -> ATGCAGAACTA
CATGCATGCCG -> ATGCATGCCGA
CATGCCGATGG -> ATGCCGATGGA
CATGCGGTGTC -> ATGCGGTGTCG
CATGCTAAAAA -> ATGCTAAAAAG
CATGGACACGG -> ATGGACACGGG
CATGGATCATT -> ATGGATCATTC
CATGTACCGTA -> ATGTACCGTAT
CATGTACCTGG -> ATGTACCTGGA
CATGTATGAAT -> ATGTATGAATA
CATGTTTAGAC -> ATGTTTAGACT
CATTAACAAGC -> ATTAACAAGCG
CATTACCTAGC -> ATTACCTAGCT
CATTAGTCACA -> ATTAGTCACAG
CATTCACAGAA -> ATTCACAGAAA
CATTCGACACA -> ATTCGACACAT
CATTCGGCTTT -> ATTCGGCTTTT
CATTGATCTTT -> ATTGATCTTTG
CATTGGTAGAA -> ATTGGTAGAAC
CATTGGTCGGG -> ATTGGTCGGGA
CATTGTGAATA -> ATTGTGAATAG
CATTTATCCAA -> ATTTATCCAAC
CATTTTTATAT -> ATTTTTATATT
CATTTTTTAAC -> ATTTTTTAACC
CCAACACCGCA -> CAACACCGCAC
CCAACCTATCT -> CAACCTATCTT
CCAAGGGGTTC -> CAAGGGGTTCT
CCAAGTGGGGG -> CAAGTGGGGGC
CCAATGAACCA -> CAATGAACCAT
CCAATGTTAGT -> CAATGTTAGTA
CCACAACCTCT -> CACAACCTCTT
CCACAATCGAC -> CACAATCGACC
CCACATTGTGA -> CACATTGTGAA
CCACCTGTACA -> CACCTGTACAA
CCACGGCCACA -> CACGGCCACAA
CCACTCCCGTA -> CACTCCCGTAG
CCAGCAAAGAG -> CAGCAAAGAGG
CCAGCCCGTGA -> CAGCCCGTGAT
CCAGGCCGCGG -> CAGGCCGCGGC
CCAGGCTTCTG -> CAGGCTTCTGC
CCAGGGACGAC -> CAGGGACGACC
CCAGGTAAGCG -> CAGGTAAGCGC
CCAGTTGCAGG -> CAGTTGCAGGC
CCATCAGCAAC -> CATCAGCAACT
CCATCTAGGGA -> CATCTAGGGAC
CCATGCGGTGT -> CATGCGGTGTC
CCATGGATCAT -> CATGGATCATT
CCATTAACAAG -> CATTAACAAGC
CCATTACCTAG -> CATTACCTAGC
CCATTGATCTT -> CATTGATCTTT
CCCAAGGGGTT -> CCAAGGGGTTC
CCCACAATCGA -> CCACAATCGAC
CCCACTCCCGT -> CCACTCCCGTA
CCCATCAGCAA -> CCATCAGCAAC
CCCATTAACAA -> CCATTAACAAG
CCCCTATCAGT -> CCCTATCAGTC
CCCCTGAAATA -> CCCTGAAATAA
CCCCTGTGTAG -> CCCTGTGTAGC
CCCGAGTAATG -> CCGAGTAATGG
CCCGGCCAAGT -> CCGGCCAAGTG
CCCGTAACTGG -> CCGTAACTGGC
CCCGTAGTGAT -> CCGTAGTGATG
CCCGTGATCGG -> CCGTGATCGGA
CCCTAAGCGGT -> CCTAAGCGGTT
CCCTACCATTA -> CCTACCATTAC
CCCTAGGGAAT -> CCTAGGGAATA
CCCTATCAGTC -> CCTATCAGTCC
CCCTCGCCGCA -> CCTCGCCGCAG
CCCTGAAATAA -> CCTGAAATAAA
CCCTGGGTTAC -> CCTGGGTTACC
CCCTGTGTAGC -> CCTGTGTAGCT
CCCTTACTCTC -> CCTTACTCTCG
CCCTTCCATTG -> CCTTCCATTGA
CCCTTCCCGTA -> CCTTCCCGTAA
CCCTTTGGGAG -> CCTTTGGGAGC
CCGAACGGCAT -> CGAACGGCATA
CCGAATTATGA -> CGAATTATGAT
CCGACCCTTCC -> CGACCCTTCCA
CCGAGGAGGCC -> CGAGGAGGCCG
CCGAGTAATGG -> CGAGTAATGGG
CCGATACTTTG -> CGATACTTTGT
CCGATGGAATT -> CGATGGAATTG
CCGCACCTGTT -> CGCACCTGTTC
CCGCATAGTAA -> CGCATAGTAAG
CCGCCCCTGTG -> CGCCCCTGTGT
CCGCGGCATCC -> CGCGGCATCCT
CCGCGGCTGTT -> CGCGGCTGTTA
CCGGCCAAGTG -> CGGCCAAGTGG
CCGTAACTGGC -> CGTAACTGGCA
CCGTAGTGATG -> CGTAGTGATGC
CCGTATACTCT -> CGTATACTCTC
CCGTATTCTAA -> CGTATTCTAAT
CCGTGATCGGA -> CGTGATCGGAA
CCGTGGTTTCG -> CGTGGTTTCGT
CCTAAGCGGTT -> CTAAGCGGTTA
CCTACCATTAC -> CTACCATTACC
CCTAGCACAAA -> CTAGCACAAAA
CCTAGCATTTT -> CTAGCATTTTT
CCTAGCTAGCC -> CTAGCTAGCCC
CCTAGGGAATA -> CTAGGGAATAT
CCTATCAGTCC -> CTATCAGTCCG
CCTATCCACAT -> CTATCCACATT
CCTATCTTCCT -> CTATCTTCCTG
CCTATTCACGC -> CTATTCACGCC
CCTCATAGCGC -> CTCATAGCGCT
CCTCATTCACA -> CTCATTCACAG
CCTCGATAAAC -> CTCGATAAACA
CCTCGCCGCAG -> CTCGCCGCAGA
CCTCGCGGAGA -> CTCGCGGAGAG
CCTCTGAGTCC -> CTCTGAGTCCC
CCTCTTCGACA -> CTCTTCGACAC
CCTGAAATAAA -> CTGAAATAAAC
CCTGCATTAGT -> CTGCATTAGTC
CCTGCGGTCAT -> CTGCGGTCATG
CCTGCGGTGCG -> CTGCGGTGCGA
CCTGGAAGCAC -> CTGGAAGCACT
CCTGGGTTACC -> CTGGGTTACCG
CCTGTACAAGT -> CTGTACAAGTA
CCTGTCAATTG -> CTGTCAATTGG
CCTGTGTAGCT -> CTGTGTAGCTG
CCTGTTCCTAT -> CTGTTCCTATT
CCTTACTCTCG -> CTTACTCTCGA
CCTTAGAACCC -> CTTAGAACCCT
CCTTATATCTA -> CTTATATCTAG
CCTTCAATACT -> CTTCAATACTT
CCTTCCATTGA -> CTTCCATTGAT
CCTTCCCGTAA -> CTTCCCGTAAC
CCTTCGAACTG -> CTTCGAACTGA
CCTTGAATTAT -> CTTGAATTATT
CCTTTAGAGGC -> CTTTAGAGGCT
CCTTTGGGAGC -> CTTTGGGAGCG
CGAAAATACAT -> GAAAATACATC
CGAACGGCATA -> GAACGGCATAG
CGAACGTTTGT -> GAACGTTTGTC
CGAACTGAGGT -> GAACTGAGGTG
CGAAGCCCAAG -> GAAGCCCAAGG
CGAATTATGAT -> GAATTATGATT
CGACACATGCT -> GACACATGCTA
CGACACATTGG -> GACACATTGGT
CGACATGTACC -> GACATGTACCG
CGACCAGGCTT -> GACCAGGCTTC
CGACCAGGTAA -> GACCAGGTAAG
CGACCCTTCCA -> GACCCTTCCAT
CGACTATGAAG -> GACTATGAAGA
CGAGCATGAAT -> GAGCATGAATA
CGAGCGCAGCG -> GAGCGCAGCGC
CGAGCTGCATA -> GAGCTGCATAC
CGAGGACATTC -> GAGGACATTCG
CGAGGAGGCCG -> GAGGAGGCCGA
CGAGGAGTGTT -> GAGGAGTGTTT
CGAGGATAGGG -> GAGGATAGGGC
CGAGGTCATTG -> GAGGTCATTGG
CGAGTAATGGG -> GAGTAATGGGC
CGAGTGGCGGG -> GAGTGGCGGGT
CGATAAACAGG -> GATAAACAGGT
CGATACTTTGT -> GATACTTTGTT
CGATCTAGTCT -> GATCTAGTCTG
CGATGAACTCA -> GATGAACTCAA
CGATGCTAAGA -> GATGCTAAGAT
CGATGGAATTG -> GATGGAATTGA
CGATGGATTTC -> GATGGATTTCC
CGATTCGTGTG -> GATTCGTGTGG
CGCAAAGGCAT -> GCAAAGGCATG
CGCACCTGTTC -> GCACCTGTTCC
CGCACGATGGA -> GCACGATGGAT
CGCAGCGCCAA -> GCAGCGCCAAC
CGCAGGAACGA -> GCAGGAACGAC
CGCATAGTAAG -> GCATAGTAAGA
CGCCAACACCG -> GCCAACACCGC
CGCCAGGGACG -> GCCAGGGACGA
CGCCAGTTGCA -> GCCAGTTGCAG
CGCCATCTAGG -> GCCATCTAGGG
CGCCCATTAAC -> GCCCATTAACA
CGCCCCTGTGT -> GCCCCTGTGTA
CGCCTAGCACA -> GCCTAGCACAA
CGCCTCATTCA -> GCCTCATTCAC
CGCCTGCATTA -> GCCTGCATTAG
CGCGCGGAGTA -> GCGCGGAGTAT
CGCGGACAGTT -> GCGGACAGTTC
CGCGGAGAGCG -> GCGGAGAGCGA
CGCGGAGTATT -> GCGGAGTATTT
CGCGGCATCCT -> GCGGCATCCTC
CGCGGCTGTTA -> GCGGCTGTTAG
CGCGTCAGGAG -> GCGTCAGGAGC
CGCTCTTCCGT -> GCTCTTCCGTG
CGCTGCGAGCA -> GCTGCGAGCAT
CGGAACAGACC -> GGAACAGACCC
CGGAAGGCAAT -> GGAAGGCAATC
CGGACAGTTCT -> GGACAGTTCTG
CGGAGAGCGAT -> GGAGAGCGATG
CGGAGGTATTT -> GGAGGTATTTA
CGGAGGTTATG -> GGAGGTTATGT
CGGAGTATTTT -> GGAGTATTTTG
CGGCAATGACG -> GGCAATGACGG
CGGCATAGCTC -> GGCATAGCTCT
CGGCATCCTCA -> GGCATCCTCAT
CGGCCAAGTGG -> GGCCAAGTGGG
CGGCCACAACC -> GGCCACAACCT
CGGCGCTGCGA -> GGCGCTGCGAG
CGGCTGTTAGT -> GGCTGTTAGTC
CGGCTTTTCAC -> GGCTTTTCACA
CGGGAGTACAG -> GGGAGTACAGG
CGGGATTAGCA -> GGGATTAGCAC
CGGGTCTGGCC -> GGGTCTGGCCC
CGGTAAGCCAG -> GGTAAGCCAGC
CGGTCATGTAC -> GGTCATGTACC
CGGTCCGACCC -> GGTCCGACCCT
CGGTGAGGGAC -> GGTGAGGGACT
CGGTGCGATGA -> GGTGCGATGAA
CGGTGTCGTGG -> GGTGTCGTGGC
CGGTGTGTCCC -> GGTGTGTCCCG
CGGTTATAACA -> GGTTATAACAT
CGTAACGTGAA -> GTAACGTGAAG
CGTAACTGGCA -> GTAACTGGCAT
CGTAGAGGCAC -> GTAGAGGCACG
CGTAGTGATGC -> GTAGTGATGCA
CGTATACTCTC -> GTATACTCTCA
CGTATTCTAAT -> GTATTCTAATT
CGTCAAGGCGA -> GTCAAGGCGAC
CGTCAGGAGCT -> GTCAGGAGCTA
CGTCCTAGCAT -> GTCCTAGCATT
CGTGAAGACCC -> GTGAAGACCCA
CGTGATCGGAA -> GTGATCGGAAC
CGTGGCCTCGC -> GTGGCCTCGCG
CGTGGCTAAAA -> GTGGCTAAAAA
CGTGGTTTCGT -> GTGGTTTCGTT
CGTGTGGTGGG -> GTGTGGTGGGT
CGTTAACAAAG -> GTTAACAAAGG
CGTTATTTCGA -> GTTATTTCGAT
CGTTGGAATTT -> GTTGGAATTTG
CGTTGTTATGA -> GTTGTTATGAA
CGTTTGTCTGG -> GTTTGTCTGGG
CTAAAAAACCT -> TAAAAAACCTA
CTAAAAAGCTG -> TAAAAAGCTGT
CTAAGATAAAT -> TAAGATAAATT
CTAAGATCATG -> TAAGATCATGT
CTAAGCGGTTA -> TAAGCGGTTAT
CTAATTTCGGA -> TAATTTCGGAA
CTACCATTACC -> TACCATTACCT
CTACTGACAGG -> TACTGACAGGG
CTAGAGACCAG -> TAGAGACCAGC
CTAGCAACGAG -> TAGCAACGAGC
CTAGCACAAAA -> TAGCACAAAAC
CTAGCATTTTT -> TAGCATTTTTT,TAGCATTTTTA
CTAGCCAATGA -> TAGCCAATGAA
CTAGCCCCTGA -> TAGCCCCTGAA
CTAGCTAGCCC -> TAGCTAGCCCC
CTAGGGAATAT -> TAGGGAATATG
CTAGGGACGAA -> TAGGGACGAAC
CTAGTCTGATC -> TAGTCTGATCG
CTATACTGCTT -> TATACTGCTTG
CTATATTCCGT -> TATATTCCGTA
CTATCAGTCCG -> TATCAGTCCGC
CTATCCACATT -> TATCCACATTG
CTATCTTCCTG -> TATCTTCCTGC
CTATGAAGACA -> TATGAAGACAA
CTATTCACGCC -> TATTCACGCCT
CTCAAAAGCAA -> TCAAAAGCAAT
CTCAATAGCGA -> TCAATAGCGAG
CTCATAGCGCT -> TCATAGCGCTC
CTCATCAGATC -> TCATCAGATCC
CTCATTCACAG -> TCATTCACAGA
CTCCCGTAGTG -> TCCCGTAGTGA
CTCGATAAACA -> TCGATAAACAG
CTCGATTCGTG -> TCGATTCGTGT
CTCGCCGCAGA -> TCGCCGCAGAG
CTCGCGGAGAG -> TCGCGGAGAGC
CTCGGTCCGAC -> TCGGTCCGACC
CTCGTAGAGGC -> TCGTAGAGGCA
CTCTATACTGC -> TCTATACTGCT
CTCTCATCAGA -> TCTCATCAGAT
CTCTCGATTCG -> TCTCGATTCGT
CTCTCGGTCCG -> TCTCGGTCCGA
CTCTCTCGGTC -> TCTCTCGGTCC
CTCTGAGTCCC -> TCTGAGTCCCG
CTCTTACTTTT -> TCTTACTTTTT
CTCTTCCGTGG -> TCTTCCGTGGT
CTCTTCGACAC -> TCTTCGACACA
CTGAAATAAAC -> TGAAATAAACA
CTGACAGGGCC -> TGACAGGGCCT
CTGAGAGCGCC -> TGAGAGCGCCA
CTGAGGTGGGA -> TGAGGTGGGAA
CTGAGTCCCGA -> TGAGTCCCGAG
CTGAGTTGAGC -> TGAGTTGAGCG
CTGATCGCAGG -> TGATCGCAGGA
CTGCAGTAACC -> TGCAGTAACCA
CTGCATACGTT -> TGCATACGTTA
CTGCATTAGTC -> TGCATTAGTCA
CTGCGAGCATG -> TGCGAGCATGA
CTGCGGTCATG -> TGCGGTCATGT
CTGCGGTGCGA -> TGCGGTGCGAT
CTGCGGTGTGT -> TGCGGTGTGTC
CTGCTAGCCAA -> TGCTAGCCAAT
CTGCTTGGGTA -> TGCTTGGGTAT
CTGGAAGCACT -> TGGAAGCACTG
CTGGACTTAGT -> TGGACTTAGTG
CTGGCATCAAG -> TGGCATCAAGA
CTGGCCCTGGG -> TGGCCCTGGGT
CTGGGGGCTTC -> TGGGGGCTTCA
CTGGGTTACCG -> TGGGTTACCGA
CTGGTGGGAAC -> TGGTGGGAACA
CTGTACAAGTA -> TGTACAAGTAG
CTGTAGGACAC -> TGTAGGACACC
CTGTCAATTGG -> TGTCAATTGGT
CTGTGCAAACA -> TGTGCAAACAT
CTGTGCTAGCA -> TGTGCTAGCAT
CTGTGTAGCTG -> TGTGTAGCTGG
CTGTTAGTCGA -> TGTTAGTCGAA
CTGTTCCTATT -> TGTTCCTATTC
CTGTTTTCGAG -> TGTTTTCGAGT
CTTAAAGTGAT -> TTAAAGTGATA
CTTACTCTCGA -> TTACTCTCGAT
CTTACTTTTTG -> TTACTTTTTGC
CTTAGAACCCT -> TTAGAACCCTT
CTTAGTGGACT -> TTAGTGGACTG
CTTATATCTAG -> TTATATCTAGA
CTTATTCTCGT -> TTATTCTCGTA
CTTCAAATACC -> TTCAAATACCT
CTTCAACGCCT -> TTCAACGCCTC
CTTCAATACTT -> TTCAATACTTC
CTTCAGATTGA -> TTCAGATTGAT
CTTCCATTGAT -> TTCCATTGATC
CTTCCCGTAAC -> TTCCCGTAACT
CTTCCGTGGTT -> TTCCGTGGTTT
CTTCCTGCGGT -> TTCCTGCGGTG
CTTCGAACTGA -> TTCGAACTGAG
CTTCGACACAT -> TTCGACACATG
CTTCTGCAGTA -> TTCTGCAGTAA
CTTCTTTTAGG -> TTCTTTTAGGG
CTTGAATTATT -> TTGAATTATTT
CTTGGGGCCTC -> TTGGGGCCTCT
CTTGGGTATGT -> TTGGGTATGTC
CTTGTGCGCCA -> TTGTGCGCCAT
CTTTAGAGGCT -> TTTAGAGGCTG
CTTTGGGAGCG -> TTTGGGAGCGG
CTTTGTGGTTC -> TTTGTGGTTCC
CTTTGTTTTAT -> TTTGTTTTATC
CTTTTAGGGGT -> TTTTAGGGGTC
CTTTTCACATT -> TTTTCACATTT
CTTTTGCTCTC -> TTTTGCTCTCT
CTTTTTGCCGC -> TTTTTGCCGCC
GAAAATACATC -> AAAATACATCA
GAAATAAACAG -> AAATAAACAGA
GAAATATTGGC -> AAATATTGGCG
GAACACGAGGA -> AACACGAGGAG
GAACAGACCCT -> AACAGACCCTT
GAACATGATTG -> AACATGATTGG
GAACCATGCGG -> AACCATGCGGT
GAACCCTTACT -> AACCCTTACTC
GAACGACTATG -> AACGACTATGA
GAACGGCATAG -> AACGGCATAGC
GAACGTTTGTC -> AACGTTTGTCT
GAACTAAGATA -> AACTAAGATAA
GAACTCAAAAG -> AACTCAAAAGC
GAACTGAGGTG -> AACTGAGGTGG
GAAGAAGTCAG -> AAGAAGTCAGT
GAAGACAATTC -> AAGACAATTCC
GAAGACCCATC -> AAGACCCATCA
GAAGCACTGTG -> AAGCACTGTGC
GAAGCCCAAGG -> AAGCCCAAGGG
GAAGGCAATCG -> AAGGCAATCGC
GAAGGGTGTGG -> AAGGGTGTGGT
GAAGTCAGTGC -> AAGTCAGTGCA
GAATAAGTGGC -> AATAAGTGGCC
GAATACTCAAT -> AATACTCAATA
GAATAGTACAG -> AATAGTACAGC
GAATATGCGGC -> AATATGCGGCG
GAATATGTATA -> AATATGTATAG
GAATGATGGGT -> AATGATGGGTA
GAATTATGATT -> AATTATGATTC
GAATTATTTAA -> AATTATTTAAA
GAATTCCCCTA -> AATTCCCCTAT
GAATTGATAAC -> AATTGATAACT
GAATTTGACCT -> AATTTGACCTG
GACAATTCCTC -> ACAATTCCTCG
GACACATGCTA -> ACACATGCTAA
GACACATTGGT -> ACACATTGGTA
GACACCCACTC -> ACACCCACTCC
GACACGGGATT -> ACACGGGATTA
GACACTGAGTT -> ACACTGAGTTG
GACAGGGCCTT -> ACAGGGCCTTG
GACAGTTCTGC -> ACAGTTCTGCT
GACATGTACCG -> ACATGTACCGT
GACATTCGGCT -> ACATTCGGCTT
GACCAGCCCGT -> ACCAGCCCGTG
GACCAGGCTTC -> ACCAGGCTTCT
GACCAGGTAAG -> ACCAGGTAAGC
GACCCATCAGC -> ACCCATCAGCA
GACCCTAGGGA -> ACCCTAGGGAA
GACCCTTCCAT -> ACCCTTCCATT
GACCCTTTGGG -> ACCCTTTGGGA
GACCGATACTT -> ACCGATACTTT
GACCTGCGGTC -> ACCTGCGGTCA
GACGAACGTTT -> ACGAACGTTTG
GACGAAGCCCA -> ACGAAGCCCAA
GACGACCAGGC -> ACGACCAGGCT
GACGCAAAGGC -> ACGCAAAGGCA
GACGGAGGTAT -> ACGGAGGTATT
GACTATGAAGA -> ACTATGAAGAC
GACTGAGAGCG -> ACTGAGAGCGC
GACTGGTGGGA -> ACTGGTGGGAA
GACTTAGTGGA -> ACTTAGTGGAC
GACTTATTCTC -> ACTTATTCTCG
GAGACCAGCCC -> AGACCAGCCCG
GAGACCCTAGG -> AGACCCTAGGG
GAGAGCGATGC -> AGAGCGATGCT
GAGAGCGCCAG -> AGAGCGCCAGT
GAGATATTGTA -> AGATATTGTAT
GAGCATGAATA -> AGCATGAATAA
GAGCGATGCTA -> AGCGATGCTAA
GAGCGCAGCGC -> AGCGCAGCGCC
GAGCGCCAGTT -> AGCGCCAGTTG
GAGCGGTAAGC -> AGCGGTAAGCC
GAGCGTCAAGG -> AGCGTCAAGGC
GAGCTAGCAAC -> AGCTAGCAACG
GAGCTCTTACT -> AGCTCTTACTT
GAGCTGCATAC -> AGCTGCATACG
GAGCTGTAGGA -> AGCTGTAGGAC
GAGGAATATGT -> AGGAATATGTA
GAGGACATTCG -> AGGACATTCGG
GAGGACGCAAA -> AGGACGCAAAG
GAGGAGGCCGA -> AGGAGGCCGAA
GAGGAGTGTTT -> AGGAGTGTTTA
GAGGATAGGGC -> AGGATAGGGCC
GAGGATCCAGG -> AGGATCCAGGC
GAGGCACGTAA -> AGGCACGTAAC
GAGGCCGAATT -> AGGCCGAATTA
GAGGCTGCGGT -> AGGCTGCGGTG
GAGGGACTTAT -> AGGGACTTATT
GAGGTATTTAT -> AGGTATTTATG
GAGGTCATTGG -> AGGTCATTGGT
GAGGTGGGAAT -> AGGTGGGAATG
GAGGTTATGTG -> AGGTTATGTGT
GAGTAATGGGC -> AGTAATGGGCA
GAGTACAGGGT -> AGTACAGGGTT
GAGTATTTTGT -> AGTATTTTGTC
GAGTCCCGAGT -> AGTCCCGAGTA
GAGTGGCGGGT -> AGTGGCGGGTC
GAGTGTTTAGT -> AGTGTTTAGTG
GAGTTGAGCGT -> AGTTGAGCGTC
GATAAACAGGT -> ATAAACAGGTG
GATAAATTCCC -> ATAAATTCCCT
GATAACTTTTG -> ATAACTTTTGC
GATACAAAGTC -> ATACAAAGTCC
GATACTTTGTT -> ATACTTTGTTT
GATAGGGCCCT -> ATAGGGCCCTC
GATATTGTATA -> ATATTGTATAT
GATCATGTTTA -> ATCATGTTTAG
GATCATTCGAC -> ATCATTCGACA
GATCCAATGTT -> ATCCAATGTTA
GATCCAGGCCG -> ATCCAGGCCGC
GATCGAGCGCA -> ATCGAGCGCAG
GATCGCAGGAA -> ATCGCAGGAAC
GATCGGAACAG -> ATCGGAACAGA
GATCTAGTCTG -> ATCTAGTCTGA
GATCTTTGTGG -> ATCTTTGTGGT
GATGAACTCAA -> ATGAACTCAAA
GATGAGATATT -> ATGAGATATTG
GATGCAAATGA -> ATGCAAATGAC
GATGCTAAGAT -> ATGCTAAGATC
GATGGAATTGA -> ATGGAATTGAT
GATGGATTTCC -> ATGGATTTCCT
GATGGGATCGA -> ATGGGATCGAG
GATGGGTAGCT -> ATGGGTAGCTT
GATTAAAGTTC -> ATTAAAGTTCG
GATTAGCACCT -> ATTAGCACCTT
GATTCGTGTGG -> ATTCGTGTGGT
GATTCTTGGGG -> ATTCTTGGGGC
GATTGATGAGA -> ATTGATGAGAT
GATTGGCCCTA -> ATTGGCCCTAA
GATTGGTTATA -> ATTGGTTATAC
GATTTCCTGTC -> ATTTCCTGTCA
GCAAACATATT -> CAAACATATTA
GCAAAGAGGAT -> CAAAGAGGATC
GCAAAGGCATG -> CAAAGGCATGT
GCAAATGACGA -> CAAATGACGAA
GCAACGAGCTG -> CAACGAGCTGC
GCAACTTGTGC -> CAACTTGTGCG
GCAATAGTATC -> CAATAGTATCG
GCAATCGCGCG -> CAATCGCGCGG
GCAATGACGGA -> CAATGACGGAG
GCACAAAACGC -> CACAAAACGCC
GCACCTGTTCC -> CACCTGTTCCT
GCACCTTTAGA -> CACCTTTAGAG
GCACGATGGAT -> CACGATGGATT
GCACGTAACGT -> CACGTAACGTG
GCACTGTGCAA -> CACTGTGCAAA
GCAGAACTAAG -> CAGAACTAAGA
GCAGCGCCAAC -> CAGCGCCAACA
GCAGCGTGGCC -> CAGCGTGGCCT
GCAGGAACGAC -> CAGGAACGACT
GCAGGCGCCTA -> CAGGCGCCTAG
GCAGTAACCAC -> CAGTAACCACG
GCATACGTTAT -> CATACGTTATT
GCATAGCTCTA -> CATAGCTCTAT
GCATAGTAAGA -> CATAGTAAGAC
GCATCAAGAGC -> CATCAAGAGCT
GCATCCTCATA -> CATCCTCATAG
GCATGAATAAG -> CATGAATAAGT
GCATGCATGCC -> CATGCATGCCG
GCATGCCGATG -> CATGCCGATGG
GCATGGACACG -> CATGGACACGG
GCATGTATGAA -> CATGTATGAAT
GCATTAGTCAC -> CATTAGTCACA
GCATTTTTATA -> CATTTTTATAT
GCATTTTTTAA -> CATTTTTTAAC
GCCAACACCGC -> CCAACACCGCA
GCCAAGTGGGG -> CCAAGTGGGGG
GCCAATGAACC -> CCAATGAACCA
GCCACAACCTC -> CCACAACCTCT
GCCAGCAAAGA -> CCAGCAAAGAG
GCCAGGGACGA -> CCAGGGACGAC
GCCAGTTGCAG -> CCAGTTGCAGG
GCCATCTAGGG -> CCATCTAGGGA
GCCATGGATCA -> CCATGGATCAT
GCCCAAGGGGT -> CCCAAGGGGTT
GCCCATTAACA -> CCCATTAACAA
GCCCCTGAAAT -> CCCCTGAAATA
GCCCCTGTGTA -> CCCCTGTGTAG
GCCCGTGATCG -> CCCGTGATCGG
GCCCTAAGCGG -> CCCTAAGCGGT
GCCCTCGCCGC -> CCCTCGCCGCA
GCCCTGGGTTA -> CCCTGGGTTAC
GCCGAATTATG -> CCGAATTATGA
GCCGATGGAAT -> CCGATGGAATT
GCCGCCCCTGT -> CCGCCCCTGTG
GCCGCGGCATC -> CCGCGGCATCC
GCCGCGGCTGT -> CCGCGGCTGTT
GCCTAGCACAA -> CCTAGCACAAA
GCCTCATTCAC -> CCTCATTCACA
GCCTCGCGGAG -> CCTCGCGGAGA
GCCTCTGAGTC -> CCTCTGAGTCC
GCCTGCATTAG -> CCTGCATTAGT
GCCTTCGAACT -> CCTTCGAACTG
GCCTTGAATTA -> CCTTGAATTAT
GCGACATGTAC -> CGACATGTACC
GCGAGCATGAA -> CGAGCATGAAT
GCGAGGACATT -> CGAGGACATTC
GCGAGGTCATT -> CGAGGTCATTG
GCGATGAACTC -> CGATGAACTCA
GCGATGCTAAG -> CGATGCTAAGA
GCGCACGATGG -> CGCACGATGGA
GCGCAGCGCCA -> CGCAGCGCCAA
GCGCCAACACC -> CGCCAACACCG
GCGCCAGGGAC -> CGCCAGGGACG
GCGCCAGTTGC -> CGCCAGTTGCA
GCGCCATCTAG -> CGCCATCTAGG
GCGCCTAGCAC -> CGCCTAGCACA
GCGCGGAGTAT -> CGCGGAGTATT
GCGCGTCAGGA -> CGCGTCAGGAG
GCGCTCTTCCG -> CGCTCTTCCGT
GCGCTGCGAGC -> CGCTGCGAGCA
GCGGACAGTTC -> CGGACAGTTCT
GCGGAGAGCGA -> CGGAGAGCGAT
GCGGAGGTTAT -> CGGAGGTTATG
GCGGAGTATTT -> CGGAGTATTTT
GCGGCATCCTC -> CGGCATCCTCA
GCGGCGCTGCG -> CGGCGCTGCGA
GCGGCTGTTAG -> CGGCTGTTAGT
GCGGGTCTGGC -> CGGGTCTGGCC
GCGGTAAGCCA -> CGGTAAGCCAG
GCGGTCATGTA -> CGGTCATGTAC
GCGGTGCGATG -> CGGTGCGATGA
GCGGTGTCGTG -> CGGTGTCGTGG
GCGGTGTGTCC -> CGGTGTGTCCC
GCGGTTATAAC -> CGGTTATAACA
GCGTCAAGGCG -> CGTCAAGGCGA
GCGTCAGGAGC -> CGTCAGGAGCT
GCGTGGCCTCG -> CGTGGCCTCGC
GCTAAAAAACC -> CTAAAAAACCT
GCTAAAAAGCT -> CTAAAAAGCTG
GCTAAGATCAT -> CTAAGATCATG
GCTACTGACAG -> CTACTGACAGG
GCTAGCAACGA -> CTAGCAACGAG
GCTAGCATTTT -> CTAGCATTTTT
GCTAGCCAATG -> CTAGCCAATGA
GCTAGCCCCTG -> CTAGCCCCTGA
GCTCTATACTG -> CTCTATACTGC
GCTCTCTCGGT -> CTCTCTCGGTC
GCTCTTACTTT -> CTCTTACTTTT
GCTCTTCCGTG -> CTCTTCCGTGG
GCTGCATACGT -> CTGCATACGTT
GCTGCGAGCAT -> CTGCGAGCATG
GCTGCGGTGTG -> CTGCGGTGTGT
GCTGGACTTAG -> CTGGACTTAGT
GCTGTAGGACA -> CTGTAGGACAC
GCTGTGCTAGC -> CTGTGCTAGCA
GCTGTTAGTCG -> CTGTTAGTCGA
GCTTCAAATAC -> CTTCAAATACC
GCTTCAGATTG -> CTTCAGATTGA
GCTTCTGCAGT -> CTTCTGCAGTA
GCTTCTTTTAG -> CTTCTTTTAGG
GCTTGGGTATG -> CTTGGGTATGT
GCTTTTCACAT -> CTTTTCACATT
GGAACAGACCC -> GAACAGACCCT
GGAACATGATT -> GAACATGATTG
GGAACGACTAT -> GAACGACTATG
GGAAGCACTGT -> GAAGCACTGTG
GGAAGGCAATC -> GAAGGCAATCG
GGAATATGCGG -> GAATATGCGGC
GGAATATGTAT -> GAATATGTATA
GGAATGATGGG -> GAATGATGGGT
GGAATTGATAA -> GAATTGATAAC
GGAATTTGACC -> GAATTTGACCT
GGACACCCACT -> GACACCCACTC
GGACACGGGAT -> GACACGGGATT
GGACACTGAGT -> GACACTGAGTT
GGACAGTTCTG -> GACAGTTCTGC
GGACATTCGGC -> GACATTCGGCT
GGACGAACGTT -> GACGAACGTTT
GGACGACCAGG -> GACGACCAGGC
GGACGCAAAGG -> GACGCAAAGGC
GGACTGGTGGG -> GACTGGTGGGA
GGACTTAGTGG -> GACTTAGTGGA
GGACTTATTCT -> GACTTATTCTC
GGAGAGCGATG -> GAGAGCGATGC
GGAGCGGTAAG -> GAGCGGTAAGC
GGAGCTAGCAA -> GAGCTAGCAAC
GGAGGAATATG -> GAGGAATATGT
GGAGGCCGAAT -> GAGGCCGAATT
GGAGGTATTTA -> GAGGTATTTAT
GGAGGTTATGT -> GAGGTTATGTG
GGAGTACAGGG -> GAGTACAGGGT
GGAGTATTTTG -> GAGTATTTTGT
GGAGTGTTTAG -> GAGTGTTTAGT
GGATAGGGCCC -> GATAGGGCCCT
GGATCATTCGA -> GATCATTCGAC
GGATCCAGGCC -> GATCCAGGCCG
GGATCGAGCGC -> GATCGAGCGCA
GGATTAGCACC -> GATTAGCACCT
GGATTTCCTGT -> GATTTCCTGTC
GGCAATCGCGC -> GCAATCGCGCG
GGCAATGACGG -> GCAATGACGGA
GGCACGTAACG -> GCACGTAACGT
GGCAGCGTGGC -> GCAGCGTGGCC
GGCATAGCTCT -> GCATAGCTCTA
GGCATCAAGAG -> GCATCAAGAGC
GGCATCCTCAT -> GCATCCTCATA
GGCATGTATGA -> GCATGTATGAA
GGCCAAGTGGG -> GCCAAGTGGGG
GGCCACAACCT -> GCCACAACCTC
GGCCATGGATC -> GCCATGGATCA
GGCCCTAAGCG -> GCCCTAAGCGG
GGCCCTCGCCG -> GCCCTCGCCGC
GGCCCTGGGTT -> GCCCTGGGTTA
GGCCGAATTAT -> GCCGAATTATG
GGCCGCGGCAT -> GCCGCGGCATC
GGCCTCGCGGA -> GCCTCGCGGAG
GGCCTCTGAGT -> GCCTCTGAGTC
GGCCTTCGAAC -> GCCTTCGAACT
GGCCTTGAATT -> GCCTTGAATTA
GGCGACATGTA -> GCGACATGTAC
GGCGCCAGGGA -> GCGCCAGGGAC
GGCGCCTAGCA -> GCGCCTAGCAC
GGCGCTGCGAG -> GCGCTGCGAGC
GGCGGAGGTTA -> GCGGAGGTTAT
GGCGGGTCTGG -> GCGGGTCTGGC
GGCTAAAAAAC -> GCTAAAAAACC
GGCTGCGGTGT -> GCTGCGGTGTG
GGCTGTTAGTC -> GCTGTTAGTCG
GGCTTCAGATT -> GCTTCAGATTG
GGCTTCTGCAG -> GCTTCTGCAGT
GGCTTTTCACA -> GCTTTTCACAT
GGGAACATGAT -> GGAACATGATT
GGGAATATGCG -> GGAATATGCGG
GGGAATGATGG -> GGAATGATGGG
GGGACGAACGT -> GGACGAACGTT
GGGACGACCAG -> GGACGACCAGG
GGGACTTATTC -> GGACTTATTCT
GGGAGCGGTAA -> GGAGCGGTAAG
GGGAGGAATAT -> GGAGGAATATG
GGGAGTACAGG -> GGAGTACAGGG
GGGATCGAGCG -> GGATCGAGCGC
GGGATTAGCAC -> GGATTAGCACC
GGGCAGCGTGG -> GGCAGCGTGGC
GGGCCCTCGCC -> GGCCCTCGCCG
GGGCCTCTGAG -> GGCCTCTGAGT
GGGCCTTCGAA -> GGCCTTCGAAC
GGGCCTTGAAT -> GGCCTTGAATT
GGGCTTCAGAT -> GGCTTCAGATT
GGGGCCTCTGA -> GGGCCTCTGAG
GGGGCCTTCGA -> GGGCCTTCGAA
GGGGCTTCAGA -> GGGCTTCAGAT
GGGGGCCTTCG -> GGGGCCTTCGA
GGGGGCTTCAG -> GGGGCTTCAGA
GGGGTCGGCAA -> GGGTCGGCAAT
GGGGTTCTATA -> GGGTTCTATAT
GGGTAATGTGT -> GGTAATGTGTT
GGGTAGCTTCT -> GGTAGCTTCTT
GGGTATGTCAA -> GGTATGTCAAA
GGGTCGGCAAT -> GGTCGGCAATG
GGGTCTGGCCC -> GGTCTGGCCCT
GGGTGTGGTGT -> GGTGTGGTGTC
GGGTTACCGAA -> GGTTACCGAAC
GGGTTCCTTAT -> GGTTCCTTATA
GGGTTCTATAT -> GGTTCTATATT
GGTAAGCCAGC -> GTAAGCCAGCA
GGTAAGCGCGT -> GTAAGCGCGTC
GGTAATGTGTT -> GTAATGTGTTG
GGTAGAACACG -> GTAGAACACGA
GGTAGCTTCTT -> GTAGCTTCTTT
GGTATGTCAAA -> GTATGTCAAAG
GGTATTTATGG -> GTATTTATGGT
GGTCAACAGCG -> GTCAACAGCGC
GGTCATGTACC -> GTCATGTACCT
GGTCATTGGTC -> GTCATTGGTCG
GGTCCGACCCT -> GTCCGACCCTT
GGTCGGCAATG -> GTCGGCAATGA
GGTCGGGAGTA -> GTCGGGAGTAC
GGTCTGGCCCT -> GTCTGGCCCTG
GGTGAGGGACT -> GTGAGGGACTT
GGTGCCGCGGC -> GTGCCGCGGCT
GGTGCGATGAA -> GTGCGATGAAC
GGTGGGAACAT -> GTGGGAACATG
GGTGGGAATGA -> GTGGGAATGAT
GGTGGGTAATG -> GTGGGTAATGT
GGTGTAATGCT -> GTGTAATGCTA
GGTGTCCGAGG -> GTGTCCGAGGA
GGTGTCGTGGC -> GTGTCGTGGCT
GGTGTGGTGTC -> GTGTGGTGTCC
GGTGTGTCCCG -> GTGTGTCCCGG
GGTGTTGAGGA -> GTGTTGAGGAC
GGTTACCGAAC -> GTTACCGAACG
GGTTATAACAT -> GTTATAACATA
GGTTATACGTT -> GTTATACGTTA
GGTTATGTGTA -> GTTATGTGTAA
GGTTCCCACAA -> GTTCCCACAAT
GGTTCCTTATA -> GTTCCTTATAT
GGTTCTATATT -> GTTCTATATTC
GGTTTCGTTGT -> GTTTCGTTGTT
GTAACATGCAG -> TAACATGCAGA
GTAACCACGGC -> TAACCACGGCC
GTAACGTGAAG -> TAACGTGAAGA
GTAACTGGCAT -> TAACTGGCATC
GTAAGACCGAT -> TAAGACCGATA
GTAAGCCAGCA -> TAAGCCAGCAA
GTAAGCGCGTC -> TAAGCGCGTCA
GTAATGCTACT -> TAATGCTACTG
GTAATGGGCAG -> TAATGGGCAGC
GTAATGTGTTG -> TAATGTGTTGC
GTACAAGTAGG -> TACAAGTAGGT
GTACAGCTTCA -> TACAGCTTCAA
GTACAGGGTTC -> TACAGGGTTCC
GTACCGTATAC -> TACCGTATACT
GTACCTGGAAG -> TACCTGGAAGC
GTACGAGGATA -> TACGAGGATAG
GTAGAACACGA -> TAGAACACGAG
GTAGAGGCACG -> TAGAGGCACGT
GTAGCTGGACT -> TAGCTGGACTT
GTAGCTTCTTT -> TAGCTTCTTTT
GTAGGACACCC -> TAGGACACCCA
GTAGGTCAACA -> TAGGTCAACAG
GTAGTGATGCA -> TAGTGATGCAA
GTATACTCTCA -> TATACTCTCAT
GTATAGTTATC -> TATAGTTATCA
GTATATCCTTA -> TATATCCTTAG
GTATCGCGGAC -> TATCGCGGACA
GTATGAATACT -> TATGAATACTC
GTATGTCAAAG -> TATGTCAAAGT
GTATGTGAGAC -> TATGTGAGACC
GTATTCTAATT -> TATTCTAATTT
GTATTTATGGT -> TATTTATGGTG
GTATTTTGTCT -> TATTTTGTCTT
GTCAAAGTATG -> TCAAAGTATGT
GTCAACAGCGC -> TCAACAGCGCA
GTCAAGGCGAC -> TCAAGGCGACA
GTCAATTGGTG -> TCAATTGGTGT
GTCACAGATTG -> TCACAGATTGG
GTCAGGAGCTA -> TCAGGAGCTAG
GTCAGTGCATG -> TCAGTGCATGC
GTCATGTACCT -> TCATGTACCTG
GTCATTGGTCG -> TCATTGGTCGG
GTCCCGAGTAA -> TCCCGAGTAAT
GTCCCGGCCAA -> TCCCGGCCAAG
GTCCCTTCCCG -> TCCCTTCCCGT
GTCCGACCCTT -> TCCGACCCTTC
GTCCGAGGAGG -> TCCGAGGAGGC
GTCCGCATAGT -> TCCGCATAGTA
GTCCTAGCATT -> TCCTAGCATTT
GTCGAAAATAC -> TCGAAAATACA
GTCGGCAATGA -> TCGGCAATGAC
GTCGGGAGTAC -> TCGGGAGTACA
GTCGTGGCTAA -> TCGTGGCTAAA
GTCTGATCGCA -> TCTGATCGCAG
GTCTGGCCCTG -> TCTGGCCCTGG
GTCTGGGGGCT -> TCTGGGGGCTT
GTCTTAAAGTG -> TCTTAAAGTGA
GTGAAGACCCA -> TGAAGACCCAT
GTGAATAGTAC -> TGAATAGTACA
GTGAGACCCTA -> TGAGACCCTAG
GTGAGCTGTAG -> TGAGCTGTAGG
GTGAGGGACTT -> TGAGGGACTTA
GTGATACAAAG -> TGATACAAAGT
GTGATCGGAAC -> TGATCGGAACA
GTGATGCAAAT -> TGATGCAAATG
GTGCAAACATA -> TGCAAACATAT
GTGCATGCATG -> TGCATGCATGC
GTGCCGCGGCT -> TGCCGCGGCTG
GTGCGATGAAC -> TGCGATGAACT
GTGCGCCATCT -> TGCGCCATCTA
GTGCTAGCATT -> TGCTAGCATTT
GTGGACTGGTG -> TGGACTGGTGG
GTGGCCATGGA -> TGGCCATGGAT
GTGGCCTCGCG -> TGGCCTCGCGG
GTGGCGGGTCT -> TGGCGGGTCTG
GTGGCTAAAAA -> TGGCTAAAAAA
GTGGGAACATG -> TGGGAACATGA
GTGGGAATGAT -> TGGGAATGATG
GTGGGAGGAAT -> TGGGAGGAATA
GTGGGGGCCTT -> TGGGGGCCTTC
GTGGGTAATGT -> TGGGTAATGTG
GTGGTGGGTAA -> TGGTGGGTAAT
GTGGTGTCCGA -> TGGTGTCCGAG
GTGGTTCCCAC -> TGGTTCCCACA
GTGGTTTCGTT -> TGGTTTCGTTG
GTGTAACATGC -> TGTAACATGCA
GTGTAATGCTA -> TGTAATGCTAC
GTGTAGCTGGA -> TGTAGCTGGAC
GTGTCCCGGCC -> TGTCCCGGCCA
GTGTCCGAGGA -> TGTCCGAGGAG
GTGTCGTGGCT -> TGTCGTGGCTA
GTGTGGTGGGT -> TGTGGTGGGTA
GTGTGGTGTCC -> TGTGGTGTCCG
GTGTGTCCCGG -> TGTGTCCCGGC
GTGTTGAGGAC -> TGTTGAGGACG
GTGTTGCATGG -> TGTTGCATGGA
GTGTTTAGTGA -> TGTTTAGTGAG
GTTAACAAAGG -> TTAACAAAGGA
GTTACCGAACG -> TTACCGAACGG
GTTAGTACGAG -> TTAGTACGAGG
GTTAGTCGAAA -> TTAGTCGAAAA
GTTATAACATA -> TTATAACATAC
GTTATACGTTA -> TTATACGTTAA
GTTATCAATCT -> TTATCAATCTG
GTTATGAATTC -> TTATGAATTCC
GTTATGTGTAA -> TTATGTGTAAC
GTTATTTCGAT -> TTATTTCGATC
GTTCCCACAAT -> TTCCCACAATC
GTTCCTATTCA -> TTCCTATTCAC
GTTCCTTATAT -> TTCCTTATATC
GTTCGTTGGAA -> TTCGTTGGAAT
GTTCTATATTC -> TTCTATATTCC
GTTCTGCTAGC -> TTCTGCTAGCC
GTTGAGCGTCA -> TTGAGCGTCAA
GTTGAGGACGC -> TTGAGGACGCA
GTTGCAGGCGC -> TTGCAGGCGCC
GTTGCATGGAC -> TTGCATGGACA
GTTGGAATTTG -> TTGGAATTTGA
GTTGTTATGAA -> TTGTTATGAAT
GTTTAGACTGA -> TTTAGACTGAG
GTTTAGTGAGC -> TTTAGTGAGCT
GTTTCGTTGTT -> TTTCGTTGTTA
GTTTGTCTGGG -> TTTGTCTGGGG
GTTTTATCGTC -> TTTTATCGTCC
GTTTTCGAGTG -> TTTTCGAGTGG
TAAAAAACCTA -> AAAAAACCTAT
TAAAAAGCTGT -> AAAAAGCTGTG
TAAACAGAAGG -> AAACAGAAGGG
TAAACAGGTGC -> AAACAGGTGCC
TAAAGAAGAAG -> AAAGAAGAAGT
TAAAGTGATAC -> AAAGTGATACA
TAAAGTTCGTT -> AAAGTTCGTTG
TAAATTCCCTA -> AAATTCCCTAC
TAACAAAGGAC -> AACAAAGGACA
TAACAAGCGAG -> AACAAGCGAGG
TAACATACAGT -> AACATACAGTG
TAACATGCAGA -> AACATGCAGAA
TAACCACCTGT -> AACCACCTGTA
TAACCACGGCC -> AACCACGGCCA
TAACGTGAAGA -> AACGTGAAGAC
TAACTGGCATC -> AACTGGCATCA
TAACTTTTGCT -> AACTTTTGCTC
TAAGACCGATA -> AAGACCGATAC
TAAGATAAATT -> AAGATAAATTC
TAAGATCATGT -> AAGATCATGTT
TAAGCCAGCAA -> AAGCCAGCAAA
TAAGCGCGTCA -> AAGCGCGTCAG
TAAGCGGTTAT -> AAGCGGTTATA
TAAGTGGCCAT -> AAGTGGCCATG
TAATGCTACTG -> AATGCTACTGA
TAATGGGCAGC -> AATGGGCAGCG
TAATGTGTTGC -> AATGTGTTGCA
TAATTTCGGAA -> AATTTCGGAAG
TACAAAGTCCC -> ACAAAGTCCCT
TACAAGTAGGT -> ACAAGTAGGTC
TACAGCTTCAA -> ACAGCTTCAAA
TACAGGGTTCC -> ACAGGGTTCCT
TACAGTGGGAG -> ACAGTGGGAGG
TACATCAAGAT -> ACATCAAGATT
TACCATTACCT -> ACCATTACCTA
TACCGAACGGC -> ACCGAACGGCA
TACCGTATACT -> ACCGTATACTC
TACCTAGCTAG -> ACCTAGCTAGC
TACCTGGAAGC -> ACCTGGAAGCA
TACCTTCAATA -> ACCTTCAATAC
TACGAGGATAG -> ACGAGGATAGG
TACGTTAACAA -> ACGTTAACAAA
TACGTTATTTC -> ACGTTATTTCG
TACTCAATAGC -> ACTCAATAGCG
TACTCTCATCA -> ACTCTCATCAG
TACTCTCGATT -> ACTCTCGATTC
TACTGACAGGG -> ACTGACAGGGC
TACTGCTTGGG -> ACTGCTTGGGT
TACTTCAACGC -> ACTTCAACGCC
TACTTTGTTTT -> ACTTTGTTTTA
TACTTTTTGCC -> ACTTTTTGCCG
TAGAACACGAG -> AGAACACGAGG
TAGAACCCTTA -> AGAACCCTTAC
TAGACTGAGAG -> AGACTGAGAGC
TAGAGACCAGC -> AGAGACCAGCC
TAGAGGCACGT -> AGAGGCACGTA
TAGAGGCTGCG -> AGAGGCTGCGG
TAGATGGGATC -> AGATGGGATCG
TAGCAACGAGC -> AGCAACGAGCT
TAGCACAAAAC -> AGCACAAAACG
TAGCACCTTTA -> AGCACCTTTAG
TAGCATTTTTA -> AGCATTTTTAT
TAGCATTTTTT -> AGCATTTTTTA
TAGCCAATGAA -> AGCCAATGAAC
TAGCCCCTGAA -> AGCCCCTGAAA
TAGCGAGGTCA -> AGCGAGGTCAT
TAGCGCTCTTC -> AGCGCTCTTCC
TAGCTAGCCCC -> AGCTAGCCCCT
TAGCTCTATAC -> AGCTCTATACT
TAGCTGGACTT -> AGCTGGACTTA
TAGCTTCTTTT -> AGCTTCTTTTA
TAGGACACCCA -> AGGACACCCAC
TAGGGAATATG -> AGGGAATATGC
TAGGGACGAAC -> AGGGACGAACG
TAGGGCCCTCG -> AGGGCCCTCGC
TAGGGGTCGGC -> AGGGGTCGGCA
TAGGTCAACAG -> AGGTCAACAGC
TAGTAAGACCG -> AGTAAGACCGA
TAGTACAGCTT -> AGTACAGCTTC
TAGTACGAGGA -> AGTACGAGGAT
TAGTATCGCGG -> AGTATCGCGGA
TAGTCACAGAT -> AGTCACAGATT
TAGTCGAAAAT -> AGTCGAAAATA
TAGTCTGATCG -> AGTCTGATCGC
TAGTGAGCTGT -> AGTGAGCTGTA
TAGTGATGCAA -> AGTGATGCAAA
TAGTGGACTGG -> AGTGGACTGGT
TAGTTATCAAT -> AGTTATCAATC
TATAACATACA -> ATAACATACAG
TATACGTTAAC -> ATACGTTAACA
TATACTCTCAT -> ATACTCTCATC
TATACTGCTTG -> ATACTGCTTGG
TATAGTTATCA -> ATAGTTATCAA
TATATCCTTAG -> ATATCCTTAGA
TATATCTAGAG -> ATATCTAGAGA
TATATTCAATT -> ATATTCAATTA
TATATTCCGTA -> ATATTCCGTAT
TATCAATCTGT -> ATCAATCTGTT
TATCAGTCCGC -> ATCAGTCCGCA
TATCCAACCTA -> ATCCAACCTAT
TATCCACATTG -> ATCCACATTGT
TATCCTTAGAA -> ATCCTTAGAAC
TATCGCGGACA -> ATCGCGGACAG
TATCGGTGAGG -> ATCGGTGAGGG
TATCGTCCTAG -> ATCGTCCTAGC
TATCTAGAGAC -> ATCTAGAGACC
TATCTTCCTGC -> ATCTTCCTGCG
TATGAAGACAA -> ATGAAGACAAT
TATGAATACTC -> ATGAATACTCA
TATGAATTCCC -> ATGAATTCCCC
TATGATTCTTG -> ATGATTCTTGG
TATGCGGCGCT -> ATGCGGCGCTG
TATGGTGTAAT -> ATGGTGTAATG
TATGTATAGTT -> ATGTATAGTTA
TATGTCAAAGT -> ATGTCAAAGTA
TATGTGAGACC -> ATGTGAGACCC
TATGTGTAACA -> ATGTGTAACAT
TATTAGATGGG -> ATTAGATGGGA
TATTCAATTAT -> ATTCAATTATC
TATTCACGCCT -> ATTCACGCCTG
TATTCCGTATT -> ATTCCGTATTC
TATTCTAATTT -> ATTCTAATTTC
TATTCTCGTAG -> ATTCTCGTAGA
TATTGGCGCCA -> ATTGGCGCCAG
TATTGTATATC -> ATTGTATATCC
TATTTAAAGAA -> ATTTAAAGAAG
TATTTATGGTG -> ATTTATGGTGT
TATTTCGATCT -> ATTTCGATCTA
TATTTTGTCTT -> ATTTTGTCTTA
TCAAAAGCAAT -> CAAAAGCAATA
TCAAAGTATGT -> CAAAGTATGTG
TCAAATACCTT -> CAAATACCTTC
TCAACAGCGCA -> CAACAGCGCAC
TCAACGCCTCA -> CAACGCCTCAT
TCAAGAGCTCT -> CAAGAGCTCTT
TCAAGATTAAA -> CAAGATTAAAG
TCAAGGCGACA -> CAAGGCGACAT
TCAATACTTCA -> CAATACTTCAA
TCAATAGCGAG -> CAATAGCGAGG
TCAATCTGTTT -> CAATCTGTTTT
TCAATTATCGG -> CAATTATCGGT
TCAATTGGTGT -> CAATTGGTGTT
TCACAGAAATA -> CACAGAAATAT
TCACAGATTGG -> CACAGATTGGC
TCACATTTATC -> CACATTTATCC
TCACGCCTGCA -> CACGCCTGCAT
TCAGATCCAAT -> CAGATCCAATG
TCAGATTGATG -> CAGATTGATGA
TCAGCAACTTG -> CAGCAACTTGT
TCAGGAGCTAG -> CAGGAGCTAGC
TCAGTCCGCAT -> CAGTCCGCATA
TCAGTGCATGC -> CAGTGCATGCA
TCATAGCGCTC -> CATAGCGCTCT
TCATCAGATCC -> CATCAGATCCA
TCATGTACCTG -> CATGTACCTGG
TCATGTTTAGA -> CATGTTTAGAC
TCATTCACAGA -> CATTCACAGAA
TCATTCGACAC -> CATTCGACACA
TCATTGGTCGG -> CATTGGTCGGG
TCCAACCTATC -> CCAACCTATCT
TCCAATGTTAG -> CCAATGTTAGT
TCCACATTGTG -> CCACATTGTGA
TCCAGGCCGCG -> CCAGGCCGCGG
TCCATTGATCT -> CCATTGATCTT
TCCCACAATCG -> CCCACAATCGA
TCCCCTATCAG -> CCCCTATCAGT
TCCCGAGTAAT -> CCCGAGTAATG
TCCCGGCCAAG -> CCCGGCCAAGT
TCCCGTAACTG -> CCCGTAACTGG
TCCCGTAGTGA -> CCCGTAGTGAT
TCCCTACCATT -> CCCTACCATTA
TCCCTTCCCGT -> CCCTTCCCGTA
TCCGACCCTTC -> CCGACCCTTCC
TCCGAGGAGGC -> CCGAGGAGGCC
TCCGCATAGTA -> CCGCATAGTAA
TCCGTATTCTA -> CCGTATTCTAA
TCCGTGGTTTC -> CCGTGGTTTCG
TCCTAGCATTT -> CCTAGCATTTT
TCCTATTCACG -> CCTATTCACGC
TCCTCATAGCG -> CCTCATAGCGC
TCCTCGATAAA -> CCTCGATAAAC
TCCTGCGGTGC -> CCTGCGGTGCG
TCCTGTCAATT -> CCTGTCAATTG
TCCTTAGAACC -> CCTTAGAACCC
TCCTTATATCT -> CCTTATATCTA
TCGAAAATACA -> CGAAAATACAT
TCGAACTGAGG -> CGAACTGAGGT
TCGACACATGC -> CGACACATGCT
TCGACACATTG -> CGACACATTGG
TCGACCAGGTA -> CGACCAGGTAA
TCGAGCGCAGC -> CGAGCGCAGCG
TCGAGTGGCGG -> CGAGTGGCGGG
TCGATAAACAG -> CGATAAACAGG
TCGATCTAGTC -> CGATCTAGTCT
TCGATTCGTGT -> CGATTCGTGTG
TCGCAGGAACG -> CGCAGGAACGA
TCGCGCGGAGT -> CGCGCGGAGTA
TCGCGGACAGT -> CGCGGACAGTT
TCGCGGAGAGC -> CGCGGAGAGCG
TCGGAACAGAC -> CGGAACAGACC
TCGGAAGGCAA -> CGGAAGGCAAT
TCGGCAATGAC -> CGGCAATGACG
TCGGCTTTTCA -> CGGCTTTTCAC
TCGGGAGTACA -> CGGGAGTACAG
TCGGTCCGACC -> CGGTCCGACCC
TCGGTGAGGGA -> CGGTGAGGGAC
TCGTAGAGGCA -> CGTAGAGGCAC
TCGTCCTAGCA -> CGTCCTAGCAT
TCGTGGCTAAA -> CGTGGCTAAAA
TCGTGTGGTGG -> CGTGTGGTGGG
TCGTTGGAATT -> CGTTGGAATTT
TCGTTGTTATG -> CGTTGTTATGA
TCTAATTTCGG -> CTAATTTCGGA
TCTAGAGACCA -> CTAGAGACCAG
TCTAGGGACGA -> CTAGGGACGAA
TCTAGTCTGAT -> CTAGTCTGATC
TCTATACTGCT -> CTATACTGCTT
TCTATATTCCG -> CTATATTCCGT
TCTCATCAGAT -> CTCATCAGATC
TCTCGATTCGT -> CTCGATTCGTG
TCTCGGTCCGA -> CTCGGTCCGAC
TCTCGTAGAGG -> CTCGTAGAGGC
TCTCTCGGTCC -> CTCTCGGTCCG
TCTGAGTCCCG -> CTGAGTCCCGA
TCTGATCGCAG -> CTGATCGCAGG
TCTGCAGTAAC -> CTGCAGTAACC
TCTGCTAGCCA -> CTGCTAGCCAA
TCTGGCCCTGG -> CTGGCCCTGGG
TCTGGGGGCTT -> CTGGGGGCTTC
TCTGTTTTCGA -> CTGTTTTCGAG
TCTTAAAGTGA -> CTTAAAGTGAT
TCTTACTTTTT -> CTTACTTTTTG
TCTTCCGTGGT -> CTTCCGTGGTT
TCTTCCTGCGG -> CTTCCTGCGGT
TCTTCGACACA -> CTTCGACACAT
TCTTGGGGCCT -> CTTGGGGCCTC
TCTTTGTGGTT -> CTTTGTGGTTC
TCTTTTAGGGG -> CTTTTAGGGGT
TGAAATAAACA -> GAAATAAACAG
TGAACCATGCG -> GAACCATGCGG
TGAACTCAAAA -> GAACTCAAAAG
TGAAGACAATT -> GAAGACAATTC
TGAAGACCCAT -> GAAGACCCATC
TGAATAAGTGG -> GAATAAGTGGC
TGAATACTCAA -> GAATACTCAAT
TGAATAGTACA -> GAATAGTACAG
TGAATTATTTA -> GAATTATTTAA
TGAATTCCCCT -> GAATTCCCCTA
TGACAGGGCCT -> GACAGGGCCTT
TGACCTGCGGT -> GACCTGCGGTC
TGACGAAGCCC -> GACGAAGCCCA
TGACGGAGGTA -> GACGGAGGTAT
TGAGACCCTAG -> GAGACCCTAGG
TGAGAGCGCCA -> GAGAGCGCCAG
TGAGATATTGT -> GAGATATTGTA
TGAGCGTCAAG -> GAGCGTCAAGG
TGAGCTGTAGG -> GAGCTGTAGGA
TGAGGACGCAA -> GAGGACGCAAA
TGAGGGACTTA -> GAGGGACTTAT
TGAGGTGGGAA -> GAGGTGGGAAT
TGAGTCCCGAG -> GAGTCCCGAGT
TGAGTTGAGCG -> GAGTTGAGCGT
TGATAACTTTT -> GATAACTTTTG
TGATACAAAGT -> GATACAAAGTC
TGATCGCAGGA -> GATCGCAGGAA
TGATCGGAACA -> GATCGGAACAG
TGATCTTTGTG -> GATCTTTGTGG
TGATGAGATAT -> GATGAGATATT
TGATGCAAATG -> GATGCAAATGA
TGATGGGTAGC -> GATGGGTAGCT
TGATTCTTGGG -> GATTCTTGGGG
TGATTGGTTAT -> GATTGGTTATA
TGCAAACATAT -> GCAAACATATT
TGCAAATGACG -> GCAAATGACGA
TGCAGAACTAA -> GCAGAACTAAG
TGCAGGCGCCT -> GCAGGCGCCTA
TGCAGTAACCA -> GCAGTAACCAC
TGCATACGTTA -> GCATACGTTAT
TGCATGCATGC -> GCATGCATGCC
TGCATGCCGAT -> GCATGCCGATG
TGCATGGACAC -> GCATGGACACG
TGCATTAGTCA -> GCATTAGTCAC
TGCCGATGGAA -> GCCGATGGAAT
TGCCGCCCCTG -> GCCGCCCCTGT
TGCCGCGGCTG -> GCCGCGGCTGT
TGCGAGCATGA -> GCGAGCATGAA
TGCGATGAACT -> GCGATGAACTC
TGCGCCATCTA -> GCGCCATCTAG
TGCGGCGCTGC -> GCGGCGCTGCG
TGCGGTCATGT -> GCGGTCATGTA
TGCGGTGCGAT -> GCGGTGCGATG
TGCGGTGTCGT -> GCGGTGTCGTG
TGCGGTGTGTC -> GCGGTGTGTCC
TGCTAAAAAGC -> GCTAAAAAGCT
TGCTAAGATCA -> GCTAAGATCAT
TGCTACTGACA -> GCTACTGACAG
TGCTAGCATTT -> GCTAGCATTTT
TGCTAGCCAAT -> GCTAGCCAATG
TGCTCTCTCGG -> GCTCTCTCGGT
TGCTTGGGTAT -> GCTTGGGTATG
TGGAAGCACTG -> GGAAGCACTGT
TGGAATTGATA -> GGAATTGATAA
TGGAATTTGAC -> GGAATTTGACC
TGGACACGGGA -> GGACACGGGAT
TGGACTGGTGG -> GGACTGGTGGG
TGGACTTAGTG -> GGACTTAGTGG
TGGATCATTCG -> GGATCATTCGA
TGGATTTCCTG -> GGATTTCCTGT
TGGCATCAAGA -> GGCATCAAGAG
TGGCCATGGAT -> GGCCATGGATC
TGGCCCTAAGC -> GGCCCTAAGCG
TGGCCCTGGGT -> GGCCCTGGGTT
TGGCCTCGCGG -> GGCCTCGCGGA
TGGCGCCAGGG -> GGCGCCAGGGA
TGGCGGGTCTG -> GGCGGGTCTGG
TGGCTAAAAAA -> GGCTAAAAAAC
TGGGAACATGA -> GGGAACATGAT
TGGGAATGATG -> GGGAATGATGG
TGGGAGCGGTA -> GGGAGCGGTAA
TGGGAGGAATA -> GGGAGGAATAT
TGGGATCGAGC -> GGGATCGAGCG
TGGGCAGCGTG -> GGGCAGCGTGG
TGGGGCCTCTG -> GGGGCCTCTGA
TGGGGGCCTTC -> GGGGGCCTTCG
TGGGGGCTTCA -> GGGGGCTTCAG
TGGGTAATGTG -> GGGTAATGTGT
TGGGTAGCTTC -> GGGTAGCTTCT
TGGGTATGTCA -> GGGTATGTCAA
TGGGTTACCGA -> GGGTTACCGAA
TGGTAGAACAC -> GGTAGAACACG
TGGTCGGGAGT -> GGTCGGGAGTA
TGGTGGGAACA -> GGTGGGAACAT
TGGTGGGTAAT -> GGTGGGTAATG
TGGTGTAATGC -> GGTGTAATGCT
TGGTGTCCGAG -> GGTGTCCGAGG
TGGTGTTGAGG -> GGTGTTGAGGA
TGGTTATACGT -> GGTTATACGTT
TGGTTCCCACA -> GGTTCCCACAA
TGGTTTCGTTG -> GGTTTCGTTGT
TGTAACATGCA -> GTAACATGCAG
TGTAATGCTAC -> GTAATGCTACT
TGTACAAGTAG -> GTACAAGTAGG
TGTACCGTATA -> GTACCGTATAC
TGTACCTGGAA -> GTACCTGGAAG
TGTAGCTGGAC -> GTAGCTGGACT
TGTAGGACACC -> GTAGGACACCC
TGTATAGTTAT -> GTATAGTTATC
TGTATATCCTT -> GTATATCCTTA
TGTATGAATAC -> GTATGAATACT
TGTCAAAGTAT -> GTCAAAGTATG
TGTCAATTGGT -> GTCAATTGGTG
TGTCCCGGCCA -> GTCCCGGCCAA
TGTCCGAGGAG -> GTCCGAGGAGG
TGTCGTGGCTA -> GTCGTGGCTAA
TGTCTGGGGGC -> GTCTGGGGGCT
TGTCTTAAAGT -> GTCTTAAAGTG
TGTGAATAGTA -> GTGAATAGTAC
TGTGAGACCCT -> GTGAGACCCTA
TGTGCAAACAT -> GTGCAAACATA
TGTGCGCCATC -> GTGCGCCATCT
TGTGCTAGCAT -> GTGCTAGCATT
TGTGGTGGGTA -> GTGGTGGGTAA
TGTGGTGTCCG -> GTGGTGTCCGA
TGTGGTTCCCA -> GTGGTTCCCAC
TGTGTAACATG -> GTGTAACATGC
TGTGTAGCTGG -> GTGTAGCTGGA
TGTGTCCCGGC -> GTGTCCCGGCC
TGTGTTGCATG -> GTGTTGCATGG
TGTTAGTACGA -> GTTAGTACGAG
TGTTAGTCGAA -> GTTAGTCGAAA
TGTTATGAATT -> GTTATGAATTC
TGTTCCTATTC -> GTTCCTATTCA
TGTTGAGGACG -> GTTGAGGACGC
TGTTGCATGGA -> GTTGCATGGAC
TGTTTAGACTG -> GTTTAGACTGA
TGTTTAGTGAG -> GTTTAGTGAGC
TGTTTTATCGT -> GTTTTATCGTC
TGTTTTCGAGT -> GTTTTCGAGTG
TTAAAGAAGAA -> TAAAGAAGAAG
TTAAAGTGATA -> TAAAGTGATAC
TTAAAGTTCGT -> TAAAGTTCGTT
TTAACAAAGGA -> TAACAAAGGAC
TTAACAAGCGA -> TAACAAGCGAG
TTAACCACCTG -> TAACCACCTGT
TTACCGAACGG -> TACCGAACGGC
TTACCTAGCTA -> TACCTAGCTAG
TTACTCTCGAT -> TACTCTCGATT
TTACTTTTTGC -> TACTTTTTGCC
TTAGAACCCTT -> TAGAACCCTTA
TTAGACTGAGA -> TAGACTGAGAG
TTAGAGGCTGC -> TAGAGGCTGCG
TTAGATGGGAT -> TAGATGGGATC
TTAGCACCTTT -> TAGCACCTTTA
TTAGGGGTCGG -> TAGGGGTCGGC
TTAGTACGAGG -> TAGTACGAGGA
TTAGTCACAGA -> TAGTCACAGAT
TTAGTCGAAAA -> TAGTCGAAAAT
TTAGTGAGCTG -> TAGTGAGCTGT
TTAGTGGACTG -> TAGTGGACTGG
TTATAACATAC -> TATAACATACA
TTATACGTTAA -> TATACGTTAAC
TTATATCTAGA -> TATATCTAGAG
TTATATTCAAT -> TATATTCAATT
TTATCAATCTG -> TATCAATCTGT
TTATCCAACCT -> TATCCAACCTA
TTATCGGTGAG -> TATCGGTGAGG
TTATCGTCCTA -> TATCGTCCTAG
TTATGAATTCC -> TATGAATTCCC
TTATGATTCTT -> TATGATTCTTG
TTATGGTGTAA -> TATGGTGTAAT
TTATGTGTAAC -> TATGTGTAACA
TTATTCTCGTA -> TATTCTCGTAG
TTATTTAAAGA -> TATTTAAAGAA
TTATTTCGATC -> TATTTCGATCT
TTCAAATACCT -> TCAAATACCTT
TTCAACGCCTC -> TCAACGCCTCA
TTCAATACTTC -> TCAATACTTCA
TTCAATTATCG -> TCAATTATCGG
TTCACAGAAAT -> TCACAGAAATA
TTCACATTTAT -> TCACATTTATC
TTCACGCCTGC -> TCACGCCTGCA
TTCAGATTGAT -> TCAGATTGATG
TTCCATTGATC -> TCCATTGATCT
TTCCCACAATC -> TCCCACAATCG
TTCCCCTATCA -> TCCCCTATCAG
TTCCCGTAACT -> TCCCGTAACTG
TTCCCTACCAT -> TCCCTACCATT
TTCCGTATTCT -> TCCGTATTCTA
TTCCGTGGTTT -> TCCGTGGTTTC
TTCCTATTCAC -> TCCTATTCACG
TTCCTCGATAA -> TCCTCGATAAA
TTCCTGCGGTG -> TCCTGCGGTGC
TTCCTGTCAAT -> TCCTGTCAATT
TTCCTTATATC -> TCCTTATATCT
TTCGAACTGAG -> TCGAACTGAGG
TTCGACACATG -> TCGACACATGC
TTCGACACATT -> TCGACACATTG
TTCGAGTGGCG -> TCGAGTGGCGG
TTCGATCTAGT -> TCGATCTAGTC
TTCGGAAGGCA -> TCGGAAGGCAA
TTCGGCTTTTC -> TCGGCTTTTCA
TTCGTGTGGTG -> TCGTGTGGTGG
TTCGTTGGAAT -> TCGTTGGAATT
TTCGTTGTTAT -> TCGTTGTTATG
TTCTAATTTCG -> TCTAATTTCGG
TTCTATATTCC -> TCTATATTCCG
TTCTCGTAGAG -> TCTCGTAGAGG
TTCTGCAGTAA -> TCTGCAGTAAC
TTCTGCTAGCC -> TCTGCTAGCCA
TTCTTGGGGCC -> TCTTGGGGCCT
TTCTTTTAGGG -> TCTTTTAGGGG
TTGAATTATTT -> TGAATTATTTA
TTGACCTGCGG -> TGACCTGCGGT
TTGAGCGTCAA -> TGAGCGTCAAG
TTGAGGACGCA -> TGAGGACGCAA
TTGATAACTTT -> TGATAACTTTT
TTGATCTTTGT -> TGATCTTTGTG
TTGATGAGATA -> TGATGAGATAT
TTGCAGGCGCC -> TGCAGGCGCCT
TTGCATGGACA -> TGCATGGACAC
TTGCCGCCCCT -> TGCCGCCCCTG
TTGCTCTCTCG -> TGCTCTCTCGG
TTGGAATTTGA -> TGGAATTTGAC
TTGGCCCTAAG -> TGGCCCTAAGC
TTGGCGCCAGG -> TGGCGCCAGGG
TTGGGAGCGGT -> TGGGAGCGGTA
TTGGGGCCTCT -> TGGGGCCTCTG
TTGGGTATGTC -> TGGGTATGTCA
TTGGTAGAACA -> TGGTAGAACAC
TTGGTCGGGAG -> TGGTCGGGAGT
TTGGTGTTGAG -> TGGTGTTGAGG
TTGGTTATACG -> TGGTTATACGT
TTGTATATCCT -> TGTATATCCTT
TTGTCTGGGGG -> TGTCTGGGGGC
TTGTCTTAAAG -> TGTCTTAAAGT
TTGTGAATAGT -> TGTGAATAGTA
TTGTGCGCCAT -> TGTGCGCCATC
TTGTGGTTCCC -> TGTGGTTCCCA
TTGTTATGAAT -> TGTTATGAATT
TTGTTTTATCG -> TGTTTTATCGT
TTTAAAGAAGA -> TTAAAGAAGAA
TTTAACCACCT -> TTAACCACCTG
TTTAGACTGAG -> TTAGACTGAGA
TTTAGAGGCTG -> TTAGAGGCTGC
TTTAGGGGTCG -> TTAGGGGTCGG
TTTAGTGAGCT -> TTAGTGAGCTG
TTTATATTCAA -> TTATATTCAAT
TTTATCCAACC -> TTATCCAACCT
TTTATCGTCCT -> TTATCGTCCTA
TTTATGGTGTA -> TTATGGTGTAA
TTTCACATTTA -> TTCACATTTAT
TTTCCTGTCAA -> TTCCTGTCAAT
TTTCGAGTGGC -> TTCGAGTGGCG
TTTCGATCTAG -> TTCGATCTAGT
TTTCGGAAGGC -> TTCGGAAGGCA
TTTCGTTGTTA -> TTCGTTGTTAT
TTTGACCTGCG -> TTGACCTGCGG
TTTGCCGCCCC -> TTGCCGCCCCT
TTTGCTCTCTC -> TTGCTCTCTCG
TTTGGGAGCGG -> TTGGGAGCGGT
TTTGTCTGGGG -> TTGTCTGGGGG
TTTGTCTTAAA -> TTGTCTTAAAG
TTTGTGGTTCC -> TTGTGGTTCCC
TTTGTTTTATC -> TTGTTTTATCG
TTTTAACCACC -> TTTAACCACCT
TTTTAGGGGTC -> TTTAGGGGTCG
TTTTATATTCA -> TTTATATTCAA
TTTTATCGTCC -> TTTATCGTCCT
TTTTCACATTT -> TTTCACATTTA
TTTTCGAGTGG -> TTTCGAGTGGC
TTTTGCCGCCC -> TTTGCCGCCCC
TTTTGCTCTCT -> TTTGCTCTCTC
TTTTGTCTTAA -> TTTGTCTTAAA
TTTTTAACCAC -> TTTTAACCACC
TTTTTATATTC -> TTTTATATTCA
TTTTTGCCGCC -> TTTTGCCGCCC
TTTTTTAACCA -> TTTTTAACCAC